id	Definition
PWN:a_bit.r.01	わずかに
PWN:abandon.v.01	見放す、置き去りにする
PWN:abandon.v.02	決して二度と要求しない意図を持ってやめる
PWN:abdomen.n.01	胸部と骨盤の間の脊椎動物の身体の部分
PWN:abdomen.n.01	胸部と骨盤の間の脊椎動物の身体の部分
PWN:ability.n.01	やり遂げることができるという特質
PWN:abortion.n.01	妊娠中絶
PWN:about.r.03	地域または近所で
PWN:about.r.07	（行動または状態について）少し足りない、または、完全に終わっていない
PWN:above.r.02	より高い場所へ、またはその中で
PWN:abrasion.n.01	皮が引き裂かれる、または擦り切れてすりむいた部分
PWN:absent.a.01	指定された場所にいないさま
PWN:absorb.v.04	また、比喩的に、取り入れる
PWN:abuse.n.02	不快感を与えるまたは傷つける意図のある失礼な表現
PWN:accept.v.02	与えられた、または勧められたものを喜んで受け取る
PWN:accept.v.04	好感をもって迎える
PWN:accident.n.01	不運な災難
PWN:accompany.v.02	一緒に行く、または動く
PWN:account.n.07	最近の取引とその結果による差引勘定の計算書
PWN:accurate.s.02	（考え、イメージ、表象、表現について）事実または真実に対して完全な一致によって特徴づけられる
PWN:accuse.v.01	告発をする
PWN:acerate_leaf.n.01	針葉樹の葉
PWN:acid.s.03	酸の特徴を持っているさま
PWN:acknowledge.v.06	（誰かが）主張されたとうりであると受け入れ、またはその力と権限を受け入れる
PWN:acme.n.01	到達可能な最も高いレベルまたは等級
PWN:acorn.n.01	オークの果実：木質のカップの形の基部にあるなめらかな薄い壁の堅果
PWN:acquire.v.05	努力で何かに勝つ
PWN:acquit.v.01	刑事告発で無罪であると申し渡す
PWN:acrimonious.s.01	強い憤慨またはシニシズムによって特徴づけられる
PWN:across.r.01	反対側に
PWN:act.n.01	委員会、協会、立法府の審議を体系化する法律文書
PWN:act.n.02	人々が行う、あるいは起こす事
PWN:act.v.02	特定の方法で振る舞う
PWN:act.v.03	役割を果たす、役を演じる
PWN:actinium.n.01	アクチニド系列の放射性元素
PWN:activity.n.01	特定の行動
PWN:actor.n.01	劇の演技者
PWN:acute.s.03	微細な区別を認識するか引き起こす能力を持っている、あるいは示すさま
PWN:ad.n.01	ある製品あるいはサービスの一般宣伝
PWN:add.v.01	追加する（に対して）
PWN:add.v.01	追加する（に対して）
PWN:addle.v.01	混同する、あるいは混乱する
PWN:address.n.03	聴衆に対して正式に口頭で伝達する行為
PWN:address.n.06	ある場所を見つけるための文書による指示
PWN:adhere.v.01	調和している、または一致している
PWN:adhere.v.06	しっかり執着
PWN:admire.v.01	賞賛を感じる
PWN:admit.v.01	真実であることを宣言するあるいは存在、現実あるいは真実を認める
PWN:admit.v.01	真実であることを宣言するあるいは存在、現実あるいは真実を認める
PWN:adobe.n.02	日干しれんが
PWN:adornment.n.01	地味さをなくすよう付け加えられる色、または趣味による装飾
PWN:adult.n.01	進んで成熟からの十分に発達した人
PWN:adultery.n.01	婚姻関係を意図的かつ不当に妨げる婚外性交
PWN:advancement.n.03	漸進的な改善または成長または発展
PWN:advice.n.01	適切な方針の提案
PWN:adz.n.01	木を切り、形成するのに使用される刃の道具
PWN:affect.v.05	感情的であるか認識影響を及ぼす
PWN:afternoon.n.01	正午から夜までの1日の一部
PWN:again.r.01	改めて
PWN:age.n.01	何かが、どれくらい存在したか
PWN:agency.n.01	政府の運営部門
PWN:agouti.n.01	中央アメリカ、南アメリカと西インド諸島のすばしっこく長い足のある兎の大きさの齧歯動物
PWN:agree.v.01	一致している
PWN:ahead.r.03	順方向に
PWN:aid.n.02	ニーズの実現や努力や目的の促進に寄与する活動
PWN:aim.v.01	何かをさし示したり、どこかへ行かせる（打撃、兵器、カメラの道具など）
PWN:air.n.01	呼吸に必要な気体の混合物（特に酸素）
PWN:airplane.n.01	翼を固定しプロペラあるいはジェットエンジンで動く飛行機
PWN:alcohol.n.01	活性剤としてのアルコールを含む蒸留酒や醸造酒
PWN:alcoholic.n.01	習慣的に過度に飲酒をする人
PWN:alive.a.01	生命を有する
PWN:alkaline.a.01	アルカリを関するものであるか、含むさま
PWN:all.a.01	数量詞
PWN:all.a.01	数量詞
PWN:allege.v.01	報告する、または支持する
PWN:allergy.n.01	特定のアレルゲンへの超過敏反応
PWN:alligator.n.02	クロコダイルに似ているが、より短くて幅広の鼻を持つ両生爬虫類二種の内の1つ
PWN:almond.n.02	アーモンドの木の卵型の食用の種
PWN:alone.r.02	ほかの誰でも、ほかの何でもなしに
PWN:alone.r.02	ほかの誰でも、ほかの何でもなしに
PWN:alone.s.02	仲間や仲間付き合いが欠如しているさま
PWN:along.r.01	前進運動を伴う
PWN:alphabet.n.01	文字を含み言葉を書くのに使用される文字の群
PWN:already.r.01	指定されたか意味された時間の前に
PWN:altar.n.02	神への捧げ物や生け贄がなされる高くなった場所
PWN:alternate.v.01	行ったり来たり動く
PWN:alternatively.r.01	代理でまたは代替手段で
PWN:aluminum.n.01	延性のある銀白色の金属元素で、主にボーキサイトに見られる
PWN:always.r.01	いつも、常に
PWN:amazed.s.01	圧倒的な驚きと衝撃の情緒的な影響で満たされた
PWN:ambassador.n.01	最高位の外交官
PWN:ambush.n.01	身を隠して待ち伏せし、急襲する行為
PWN:american_football.n.01	ゲームは長方形のフィールドの11人のプレーヤーの2つのチームで長さ100ヤードであるのにプレーした
PWN:americium.n.01	放射性超ウラン金属元素
PWN:amulet.n.01	首のまわりにつるされ、悪魔または病に対して魔力的なお守りの効果があるとされる宝石の1つまたは細かい装身具
PWN:amuse.v.01	気持ちのよい、愉快、あるいは良い感じの風習で占める
PWN:amusing.s.02	笑いを起こすか、誘うさま
PWN:anal.a.01	肛門の、または、肛門に関する
PWN:analyze.v.01	本質的な特徴か意味を発見するために、詳細に検討し分析する
PWN:ananas.n.01	熱帯のアメリカ産の植物の属は、剣形の葉と、（パイナップルのような）いくつかの花の実からなる肉厚の複合果実を持つ
PWN:ancestor.n.01	自分が系統を引く（通常、祖父母よりも遠い）人
PWN:anchor.n.01	船が動くのを防ぐ機械装置
PWN:anchorite.n.01	宗教的理由のために社会から退いた人
PWN:ancient.s.02	非常に古い
PWN:angel.n.01	神に付き添う霊的な存在
PWN:anger.n.02	怒っていること
PWN:anger.v.01	怒らせる
PWN:anger.v.02	腹を立てる
PWN:angle.n.01	交差する2本の線または平面の間の空間
PWN:angry.a.01	怒りを感じるか、示すさま
PWN:angstrom.n.01	メートル法の長さで、1メートルの100億分の1（または0.0001ミクロン）と等しい
PWN:animal.n.01	自発的な運動に特徴付けられる、生命を持つ有機体
PWN:animation.n.01	生活の状態、または生きている状態
PWN:ankle.n.01	脛骨と腓骨の遠心端と距骨の近位端の間の平面関節
PWN:announce.v.01	知らせる
PWN:announce.v.01	知らせる
PWN:anoint.v.02	油か軟膏を施す
PWN:answer.v.01	言葉で反応する
PWN:ant.n.01	組織化された群に生きる社会性昆虫
PWN:anteater.n.02	熱帯アメリカ産の歯が無くてアリやシロアリを主食にする貧歯目アリクイ科の各種の哺乳動物
PWN:anteroom.n.01	大きい入り口、応接室または地域
PWN:antimony.n.01	4つの同素体を持つ金属元素
PWN:anus.n.01	消化管の末端にある排出のための開口部
PWN:anvil.n.01	重い鉄か鉄鋼のブロックで、その上で溶銑がハンマーによって成形される
PWN:anxiety.n.02	（通常不明確な）不幸な出来事が起こるのではと思う、あいまいな不快感
PWN:any.s.01	指定なく、一つ、いくつかの、一つずつの、あるいは全ての
PWN:apart.r.01	場所、位置、または時間的に切り離された、または隔てられた
PWN:apartment_building.n.01	アパートメントに分けられる建物
PWN:aperture.n.02	開口部
PWN:apparel.n.01	一般的に衣服
PWN:appearance.n.01	人や物の、外に現われた目に見える様子
PWN:apple.n.01	皮は赤や黄や緑、果肉は白っぽくぱりぱりしていて味は甘いものから酸っぱいものまである果物
PWN:approach.v.01	そこに向かって動く
PWN:appropriate.v.02	侵略の後などに、力づくで所有物を取る
PWN:approve.v.01	認可を与える
PWN:approximately.r.01	（量について）不正確であるがとても正確に近い
PWN:april.n.01	3月の次で、5月の前の月
PWN:apron.n.01	洋服が汚れないように腰の周りで結んで身に着ける、布や革あるいはプラスティック製の覆い
PWN:apt.s.03	知的で頭の回転が速く、機知に富む
PWN:arch.n.01	開口にかかる垂直面にある曲がった形
PWN:arch.n.04	通路の上にかかり、上部の重量を支えている（通例カーブした）石造構造
PWN:area.n.01	境界が不確かな特定の地理的地域（通常いくつかの特別な目的にかなうか、その住民、文化または地理学によって特徴付けられる）
PWN:area.n.06	境界線で閉じた2次元の表面の広がり
PWN:argon.n.01	無色、無臭の不活性気体
PWN:arise.v.03	立ち上がる
PWN:arm.n.01	人間の手足
PWN:armadillo.n.01	体が頑強な角質板で覆われた主に夜行性の穴居性哺乳動物
PWN:armlet.n.01	腕の周りに飾りにつける
PWN:armor.n.01	金属でできていて、戦闘中に使用される保護カバー
PWN:armpit.n.01	肩につながる、腕の下のくぼみ
PWN:army.n.01	陸上の軍隊組織
PWN:army.n.01	陸上の軍隊組織
PWN:aroused.s.06	（人について）過度に感情に影響される
PWN:arrange.v.01	適切な、または規則正しい順番に並べる
PWN:arrive.v.01	目的地に着く
PWN:arrive.v.01	目的地に着く
PWN:arrogant.s.01	横柄なプライドから不当な重要さの感情を持つまたは示す
PWN:arrow.n.01	方向または関係を示す記号
PWN:arrow.n.02	まっすぐな薄い柄と一方に矢尻もう一方に静止した羽根をもつ発射体
PWN:arrow.n.02	まっすぐな薄い柄と一方に矢尻もう一方に静止した羽根をもつ発射体
PWN:arsenic.n.02	3つの同素形を持つ猛毒の金属元素
PWN:arson.n.01	財産を破壊するために、悪意をもって燃やすこと
PWN:art.n.01	人間活動の産物
PWN:art.n.02	美しい物や意味のある物の創造
PWN:artery.n.01	血液を心臓から身体へ運ぶ血管
PWN:artery.n.01	血液を心臓から身体へ運ぶ血管
PWN:article.n.01	出版物の独立した部分を成すノンフィクションの散文
PWN:artificial_language.n.01	特定の目的のために故意につくられる言語
PWN:artificial.a.01	自然ではなくむしろ人為的に考案された
PWN:artist.n.01	感性と想像力あふれる作品を生み出す人
PWN:ascend.v.01	上昇する
PWN:ascend.v.01	上昇する
PWN:ash.n.01	何かが燃やされた後の残余物
PWN:ash.n.02	トネリコ属の各種の落葉性の羽状の葉を持つ、観賞植物または材木用樹木の総称
PWN:ask.v.01	尋ねる
PWN:ask.v.02	誰かに何かの要請か要求を行なう
PWN:ask.v.05	質問を記述して、答えを予測する
PWN:aslant.s.01	斜めになったまたは傾斜した方向を持っている
PWN:assemble.v.01	構成要素や構成員を寄せ集めて作る
PWN:assume.v.01	真実であるあるいは事実であると取る
PWN:astatine.n.01	非常に不安定な放射性元素（ハロゲン系で最も重い）
PWN:at_least.r.02	少なくとも
PWN:at_most.r.01	それよりも大きくないさま
PWN:atheism.n.01	神はいないとする主義あるいは信念
PWN:atheist.n.01	神の存在を否定する人
PWN:athlete.n.01	スポーツ競技を行う訓練を受けた人
PWN:atom.n.01	要素の化学的特質を持った最も小さい要素構造
PWN:attach_to.v.01	出来事または実体に関係するまたは存在する
PWN:attach.v.01	取り付けられる
PWN:attack.n.05	攻撃する行為
PWN:attack.v.01	攻撃または襲撃をする
PWN:attention.n.01	ある人が（相対的に）他を除外して身の回りのある特徴にだけに集中する過程
PWN:attentive.a.01	世話または注意をするさま
PWN:attract.v.01	心理学的力または物理的属性という手段でそのものまたはその人自身に直接向けられた
PWN:attribute.n.02	実体に属するまたは実体に特徴的な抽象的実体
PWN:august.n.01	7月の後、9月の前の月
PWN:aunt.n.01	父や母の姉妹
PWN:aurora_borealis.n.01	北半球のオーロラ
PWN:australia.n.01	オーストラリア大陸全体を占める国
PWN:authority.n.01	命令をするか、決定をする力または権利
PWN:autism.n.01	自己への異常な没頭
PWN:automatic.a.01	人間の介入が最小の状態で作動する
PWN:auxiliary.s.01	収容力を補助する機能のある
PWN:available.a.01	入手または利用可能で、使用またはサービスの準備が整っている
PWN:avaricious.s.01	富などを得るこを極端に望む
PWN:avaricious.s.01	富などを得るこを極端に望む
PWN:avoid.v.01	接触がないままでいる
PWN:awake.a.01	睡眠している状態でない
PWN:awaken.v.01	目が覚める、意識がある
PWN:awareness.n.01	知識を持つこと
PWN:away.r.01	特定のもの、場所または位置から
PWN:awl.n.01	表面に印を付けたり小さな穴をうがつのに用いる尖った道具
PWN:ax.n.01	取っ手の一方に重い刃のついた刃もの
PWN:axle.n.01	車が回転するシャフト
PWN:baby.n.01	非常に年の若く（生後1年までの）、まだ歩いたり話したりできない子供
PWN:back.n.01	人間（または動物）の首から脊柱の端までの後部
PWN:back.r.01	前の位置に向かってまたはそれの中の
PWN:back.r.02	後ろあるいは後部で、あるいは、のほうに向かって
PWN:bacon.n.01	塩味を付けられて、乾かされるか、または煙る豚の後部と側面
PWN:bad.a.01	望ましくない、または否定的な品質の
PWN:bag.n.01	口が1つの変形可能な容器
PWN:bait.n.02	魚または他の動物を捕まえたり殺したりするため、危険なところにおびき寄せるのに使用する物
PWN:bake.v.02	オーブンの乾式加熱で料理する
PWN:balance.n.01	平衡状態
PWN:bald.s.02	すべてまたは大部分の頭皮の毛がないさま
PWN:baldhead.n.01	頭のはげた人
PWN:ball.n.01	ゲームで打ったり、投げたり、蹴ったりする球体
PWN:ball.n.03	球の形をした物体
PWN:ball.n.08	小さな塊
PWN:balloon.n.01	ガスまたは熱い空気で満たされる大きく頑丈な軟式のバッグ
PWN:bamboo.n.01	タケの堅い木質の茎
PWN:banana.n.01	大きな全縁の葉の頂生の樹冠を持ち、通常細長い果実の垂れ下がった房を実らせるバショウ属のいくつかの熱帯と亜熱帯の高木のような草本の総称
PWN:banana.n.02	三日月形の細長い、果肉が柔らかく甘い黄色い果物
PWN:bandicoot.n.01	オーストラリア・隣接諸島産の敏速でネズミのような地上にすむ様々な有袋動物類の総称
PWN:bantam.s.01	非常に小さい
PWN:banyan.n.01	東インドの木
PWN:bar.n.03	金属または木材の断片
PWN:barbeque.v.01	野外で、バーベキューグリルで料理する
PWN:bare.s.01	完全に裸の
PWN:barefoot.s.01	靴なしで
PWN:barium.n.01	柔らかい銀白色のアルカリ土類の金属元素
PWN:bark.n.01	木質の茎と根の丈夫な保護カバーと他の木質の植物
PWN:bark.v.04	ほえている音を出す
PWN:barley.n.02	先史時代から栽培されている
PWN:barn_owl.n.01	しばしば納屋と他の構造に住んでいる黄褐色と白色のまだらなフクロウ
PWN:barn.n.01	穀物や動物の餌を保管したり家畜を収容している郊外の農舎
PWN:barrel.n.01	銃が発射されたときに弾の飛び出す管
PWN:barrel.n.02	液体を入れる筒状の容器
PWN:barrier.n.01	自由な運動を妨げる構造または物体
PWN:barroom.n.01	カウンタ越しにアルコール飲料が出される部屋か建物
PWN:barrow.n.03	小さい荷物を運ぶためのカート
PWN:barter.v.01	金銭を介さない物品の交換
PWN:base.n.14	自分が在住し、活動を始めて終わらせる場所
PWN:baseball.n.01	9人のプレーヤーの2つのチームの間には、野球がある状態でされた球技
PWN:basement.n.01	部分的にまたは全体が地下にある構造物の最も低い部分
PWN:basket.n.01	通例編まれたとってのある入れ物
PWN:basketball.n.01	5人で成る2つのチームによるコート上で行われる試合
PWN:bat.n.01	膜質の翼を形成するのに変化した前肢を持ち、航行用の反響定位に解剖学上適応した夜行性のネズミのような哺乳動物
PWN:bat.n.05	さまざまなゲームでボールを打つのに使用されるクラブ
PWN:batch.n.02	大きい数か量または範囲
PWN:batch.n.03	一緒に処理される物や人の集まり
PWN:bathe.v.01	全身を清潔にする
PWN:bathroom.n.01	浴槽またはシャワーと通常洗面台とトイレを含んでいる部屋（住居のように）
PWN:bathtub.n.01	比較的大きな蓋のない容器で、湯水を浸し体を洗えるようにしたもの
PWN:battery.n.02	電気を発生させる装置
PWN:battle-ax.n.01	戦闘用大斧
PWN:battle.n.01	戦争中の、敵対する軍事力との対立的な会議
PWN:battle.n.01	戦争中の、敵対する軍事力との対立的な会議
PWN:bay.n.01	入り江より大きい、しかし、湾より小さい海岸線のくぼみ
PWN:bay.n.01	入り江より大きい、しかし、湾より小さい海岸線のくぼみ
PWN:be_born.v.01	出産によって出現する
PWN:be.v.01	存在の品質がある
PWN:be.v.03	ある位置か領域を占める
PWN:be.v.11	生きて、生きる
PWN:beach.n.01	海や湖に降りてゆく砂地
PWN:bead.n.01	真ん中に穴の開いた小さい球体
PWN:beak.n.02	鳥の骨性の突き出た両顎
PWN:beam.n.02	太くて長い木、金属、またはコンクリート片などで、建築に使用される
PWN:beam.n.04	光の列（ビーコンから発せられるような）
PWN:bean_curd.n.01	豆乳を固めたチーズのような食物
PWN:bean.n.01	食物に使用されるマメ科のさまざまな食用の種のどれか
PWN:bear.n.01	巨大な蹠行性の肉食性、または雑食性の哺乳動物で、長くて毛むくじゃらの毛と強い鉤爪を持つ
PWN:beard.n.01	男性の顔の下の部分に生える毛
PWN:beat.v.03	乱打する
PWN:beat.v.03	乱打する
PWN:beautiful.a.01	感覚を活気づけ、知的情緒的賞賛を喚起する
PWN:beaver.n.07	水掻きの有る後足と幅広い偏平な尾を持つ半水生の大型齧歯動物
PWN:beckon.v.01	手またはうなずきによる信号
PWN:become.v.01	特定の状態または状態になる、あるいはとみなす
PWN:become.v.01	特定の状態または状態になる、あるいはとみなす
PWN:bed.n.01	家具の1つで眠るための場所を提供する
PWN:bedroom.n.01	主として眠るための部屋
PWN:bee.n.01	社会性・単生種を含む非常に多い毛むくじゃらの昆虫の総称
PWN:beech.n.01	丸い広がる樹冠となめらかな灰色の樹皮といがに囲まれた小さな甘い食用に適する三角形の堅果を持つ、いくつかの大きな落葉性の高木の総称
PWN:beehive.n.04	ミツバチの群れを入れる人工の入れ物
PWN:beer.n.01	ホップで風味をつけられる穀物（または穀類の混合物）を発酵させることによって作られるアルコール飲料の一般的な名前
PWN:beeswax.n.01	ミツバチが巣を作るために分泌する黄色または茶色の蝋
PWN:beget.v.01	子をもうける
PWN:beggar.n.01	物乞をして生活する貧者
PWN:begin.v.03	発動する、はじめさせる
PWN:beginning.n.01	何かの初めの部分の出来事
PWN:beginning.n.04	何かが生まれて、始まる場所
PWN:behavior.n.01	自分らしく振る舞う、または自分を管理する方法
PWN:behind.r.01	後ろ向きにまたは後ろに
PWN:believe.v.01	真実として受け取る
PWN:believe.v.03	何かを確信する
PWN:bell.n.01	叩くと音の出る金属製の中が空の装置
PWN:beloved.s.01	心から愛されている
PWN:belt.n.02	（通例ウェストのところで）体の周りを結んだりバックルで止めたりする帯
PWN:bench.n.01	2人以上が座れる長いす
PWN:bend.v.01	曲線を形成する
PWN:bended.s.01	背中と膝を使用する
PWN:benefit.n.01	必要時に出される財政援助
PWN:benefit.n.02	幸福を助け、推進する何か
PWN:berkelium.n.01	放射性の超ウラン元素
PWN:berry.n.01	多数の小さく果肉のある食用の果物の総称
PWN:beryllium.n.01	軽くて強いもろい灰色の有毒な二価金属元素
PWN:besides.r.02	さらに
PWN:bespeak.v.01	の信号または徴候である
PWN:better.a.01	素晴らしさ、品質、好ましさあるいは適合性のもう一つ（同じ部類、組、種類の）より優れている
PWN:better.v.02	よりよくする
PWN:between.r.01	その合間に
PWN:between.r.02	中間で
PWN:beverage.n.01	飲むのに適した液体の総称
PWN:beverage.n.01	飲むのに適した液体の総称
PWN:beyond.r.01	空間、時間、程度がさらに遠い
PWN:bible.n.01	キリスト教の聖典
PWN:bicycle.n.01	2つの車輪があり、足のペダルで動く車両
PWN:big_brother.n.02	兄
PWN:big_sister.n.01	姉
PWN:bill.n.02	商品またはサービスに対して支払いの義務があるお金の明細書
PWN:billiards.n.01	布で覆われた（縁にクッションの付いた）長方形のテーブルの上で行われる数種のゲームで、先細になった長い棒を使って象牙（または象牙模造の）ボールを進ませる
PWN:billy.n.02	雄のヤギ
PWN:birch.n.02	薄い剥離する樹皮を持つ、シラカンバ属のカバノキ科の高木または低木
PWN:bird.n.01	羽毛と、翼として変形された前肢によって特徴付けられる温血の産卵する脊椎動物
PWN:birth_certificate.n.01	ある人の出生の詳細を記した公式文書のコピー
PWN:birth.n.01	何か（特に生命あるもの）が始まった時間
PWN:birth.n.02	生まれること
PWN:bishop.n.01	精神と管理権力を持つキリスト教聖職者の高位の一員
PWN:bishop.n.03	コマが置かれていない同色のマスを斜めに進むことができるコマ
PWN:bishop.n.03	コマが置かれていない同色のマスを斜めに進むことができるコマ
PWN:bismuth.n.01	重くもろい反磁性三価元素（化学的にヒ素とアンチモンに似た）
PWN:bite.v.01	つかむか、中断するか、または引き裂く、歯か顎で
PWN:bitter.s.06	鋭く、刺激的な味経験を起こす
PWN:bitter.s.06	鋭く、刺激的な味経験を起こす
PWN:black.a.01	最高レベルの黒の無彩色であるさま
PWN:blacksmith.n.01	ハンマーと金床で鉄を鍛造し形成する鍛冶屋
PWN:blade.n.09	（通例）切る刃のついた道具または武器の平たい部分
PWN:blame.v.01	責めを負わせるまたは責任を負わせる
PWN:blanket.n.01	ベッドの中の人を暖かくする寝具
PWN:blast.v.07	弾丸を発射する
PWN:blemish.n.01	何か（特に人の体の上で）概観を損なう特徴または欠陥
PWN:blend.v.03	異なる要素を混ぜ合わせる
PWN:bless.v.01	を祝福する
PWN:blind.a.01	見ることができない
PWN:blind.n.01	重度の視覚障害を持った人々、グループとしてみなされる
PWN:blink.v.01	短時間目を閉じる
PWN:blister.n.03	漿液で満たされた皮膚の隆起
PWN:block.n.01	何かの固体の部分（通常、平らな長方形の側面を持つ）
PWN:blood.n.01	心臓によって体全体に供給され、血漿、血球および血小板を含んだ流体（脊椎動物では赤い）
PWN:blouse.n.01	女性が上半身に着る物
PWN:blow.n.01	拳や武器で力まかせに殴ること
PWN:blow.v.01	強く息を吐き出す
PWN:blow.v.02	吹いている、嵐が吹いている
PWN:blowy.s.01	風か微風に富むか、またはさらされている
PWN:blue.s.01	緑とスミレの中間の色の
PWN:blunt.s.02	ナイフまたは他の刃に使われた
PWN:boar.n.02	去勢されていない雄豚
PWN:board.n.02	のこぎりで切られた木の丈夫な一片
PWN:boast.v.01	見せびらかす
PWN:boat.n.01	水上を行くための小さい船
PWN:bobbin.n.01	糸、テープ、フィルムその他の柔軟な材質の物を巻き付ける巻取り機
PWN:body_hair.n.01	人の体の上に成長している短い髪
PWN:body_hair.n.01	人の体の上に成長している短い髪
PWN:body_louse.n.01	人間の体に集る寄生シラミ
PWN:body.n.01	有機体の全構造（動物、植物または人間）
PWN:bohrium.n.01	超ウラン元素
PWN:boil.n.01	膿を持った硬い芯のある痛みを伴う腫れもの
PWN:boil.v.01	沸点に達し、液体から気体へ変化する
PWN:boil.v.03	沸点まで上げて、またはその状態を維持する
PWN:boisterous.s.03	激しく動揺し、荒れ狂った
PWN:bolt.n.03	鍵で開け閉めする錠の部分
PWN:bomb.n.01	導火線をつけて特定の条件下で爆発するようにしてある爆発装置
PWN:bomb.n.01	導火線をつけて特定の条件下で爆発するようにしてある爆発装置
PWN:bone.n.01	脊椎動物の骨格を構成する堅い結合組織
PWN:book.n.01	出版されている（綴じられたページに印刷された）著作物
PWN:bookcase.n.01	家具の1つで本を入れておくための棚がある
PWN:bookshop.n.01	本が販売される店
PWN:boomerang.n.01	曲げられた木片
PWN:boot.n.01	足全体と下脚を覆う靴
PWN:bore.v.02	穴を作る、特にとがった動力または手工具で
PWN:boring.s.01	そのため原因精神的な疲労に関しての関心を欠くさま
PWN:boron.n.01	三価のメタロイド元素
PWN:borrow.v.01	一時的に得る
PWN:borrow.v.01	一時的に得る
PWN:botch.v.01	台無しにする、壊すまたは破滅させる
PWN:bottle.n.01	飲物または他の液体を貯蔵するために使用されたガラスまたはプラスチック入れ物
PWN:bottom.n.01	あるものの下側の面
PWN:bottom.n.02	あらゆるものの最も低い部分
PWN:bounce.v.01	後ろに跳ねる
PWN:boundary_line.n.01	境界を示す線
PWN:boundary.n.02	領域の範囲を決定づける線
PWN:bow.n.04	矢を射るための攻撃の集団で、湾曲した弾力のある木片に、矢を前に飛ばすひもがピンと張ってある
PWN:bowed_stringed_instrument.n.01	弓で演奏する弦楽器
PWN:bowl.n.01	上が開いている円形の容器
PWN:box.n.01	（通例長方形の）容器
PWN:bracelet.n.02	飾りとして腕の周りに着ける
PWN:brackish.s.02	わずかに塩辛い（特に海水および淡水の混合物を含んでいることから）
PWN:braid.n.01	編んだり撚ったりした髪型
PWN:braid.n.01	編んだり撚ったりした髪型
PWN:braid.v.01	縁取りまたは飛越し走査によって作る
PWN:brain.n.01	すべての高度神経中枢を含む中枢神経系のその部分
PWN:brainsick.s.01	狂気または精神異常により影響を受ける
PWN:brake.v.02	ブレーキを踏むことで停止させる
PWN:branch.n.01	より大きく複雑な組織の部門
PWN:branch.n.02	茎が分裂したもの、または植物の主要な茎から生じる派生的な茎
PWN:branch.n.03	分岐した、または枝分かれした形の一部分
PWN:branchlet.n.01	小枝、または枝が分かれたもの（特に末端部分）
PWN:brandy.n.01	ワインまたは発酵する果物ジュースから蒸留される
PWN:brass.n.01	銅と亜鉛の合金
PWN:brave.a.01	勇気を持っている、または示すさま
PWN:brawl.v.01	騒々しく、怒って、または、破壊的に喧嘩する
PWN:brazilian.n.01	ブラジルの出身者、または、居住者
PWN:bread.n.01	小麦粉またはミールの生地で作られ、通常はイーストまたはベーキングパウダーでふくらまされ、それから焼かれる食物
PWN:break.v.05	完全性を破壊する
PWN:break.v.42	機能しなくなる
PWN:breakfast.n.01	1日の最初の食事（通常は朝の）
PWN:breast.n.02	女性の胸にある2つの柔らかい肉質の乳を分泌する腺器官
PWN:breastfeed.v.01	乳を与える
PWN:breath.n.02	呼吸において吸われたり吐かれたりする空気
PWN:breathe.v.01	肺に空気を吸い込みはき出す
PWN:brick.n.01	太陽の光または窯で焼かれた粘土の矩形ブロック
PWN:bridge.n.01	川・運河・鉄道などの障害物を人や車が横断できるようにする構造物
PWN:brief.s.01	短い期間または距離の
PWN:bright.a.01	光をすぐに、あるいは大量に発する、または反射するさま
PWN:bright.a.01	光をすぐに、あるいは大量に発する、または反射するさま
PWN:bright.s.02	目立つ色をしているさま
PWN:bring_around.v.02	再び健康にするよう、治療する
PWN:bring.v.01	自らで、何かまたは誰かをどこかへ連れて行く
PWN:bring.v.04	後を追って行く、または追って来て、引き戻す、あるいは連れ戻す
PWN:broad_bean.n.01	ソラマメ植物の種子
PWN:broccoli.n.01	堅い緑色のつぼみの密集した房がある植物
PWN:broken.s.11	正常運転できない状態
PWN:bromeliaceae.n.01	熱経済的価値のあるものが複数含まれる帯アメリカ原産の植物の科（パイナップルのような）
PWN:bromine.n.01	ハロゲンに属する非金属の重い揮発性で腐食性の液体要素
PWN:brook.n.01	riverより狭い自然の水流（しばしば川にそそぎ込む）
PWN:broom.n.01	掃くための掃除道具
PWN:brother.n.01	誰かと親を同じくする男性
PWN:brow.n.01	顔の眼の上の部分
PWN:brown.s.01	木か地球の色に似た色の
PWN:bruise.n.01	皮膚を傷つけないで、若干の変色に終わる怪我
PWN:brush.n.02	毛または剛毛が取手に堅くつけられている道具
PWN:brush.v.04	さっと通り抜ける、または押し寄せる
PWN:bucket.n.01	上面が開いたおおよそ筒状の容器
PWN:buckwheat.n.01	ソバ属の一種
PWN:bud.n.01	部分的に開いた花
PWN:buddha.n.01	仏教の創始者
PWN:buddhism.n.01	仏陀を崇拝する宗教で、特にアジアを中心に多くのグループが存在する
PWN:buddhist.n.01	ブッダの教えに従う人
PWN:building.n.01	屋根と壁があり、1つの場所にほぼ永久的に立っている構造物
PWN:bulge.n.01	膨れ出るか、突出しているか、その環境から突出する何か
PWN:bull.n.01	去勢されていない雄の畜牛
PWN:bullet.n.01	銃から発射される発射体
PWN:bumble.v.03	つっかえつっかえ話す
PWN:bump.n.01	打撲によって身体に生じるこぶ
PWN:bunch.n.01	類似している物の密な集まり
PWN:bundle.n.02	持ち運んだり貯蔵したりするためいくつかのものを1つに縛ったもの
PWN:bundle.n.02	持ち運んだり貯蔵したりするためいくつかのものを1つに縛ったもの
PWN:burn.v.01	火によって破壊する
PWN:burn.v.03	燃焼を経る
PWN:burn.v.07	燃焼を被る原因
PWN:burst.v.01	まるで内圧からあるように、突然、そして、激しく、開く
PWN:bury.v.02	墓または墓の場所
PWN:bus.n.01	多くの乗客を乗せる乗り物
PWN:business.n.01	商工業の会社とその構成員
PWN:bustard.n.01	強力な迅速な飛行ができる大きいずっしりとした体の主として陸生の狩猟鳥
PWN:bustle.n.01	急激で活発な動揺
PWN:butcher.v.01	通常食糧消費のために殺す（動物）
PWN:butter_knife.n.01	切れ味が悪い小型ナイフ
PWN:butter.n.01	牛乳またはクリームをかき回して作る、食用の脂肪球の乳状液
PWN:butterfly.n.01	通常、こぶのある触覚と広い色の豊富な羽をもつ細い体を持つ昼行動性の昆虫
PWN:buttocks.n.01	人間の体のうち、自分が上に座る肉付きのよい部分
PWN:button.n.01	ボタン穴を通してはまるようにシャツやコートなどに縫われた丸い留め
PWN:buy.v.01	購入によって得る
PWN:by.r.01	任意の点を通過するように
PWN:cabbage.n.01	様々なキャベツ類の総称
PWN:cable.n.02	電気、光学式シグナル、電力を送るための導線
PWN:cadaver.n.01	人間の死体
PWN:cadmium.n.01	軟質の蒼白な延性のある順応性である有毒な二価金属元素
PWN:cage.n.01	鳥や動物を入れておくものでワイヤや金属製の棒でできている
PWN:calabash.n.01	ヒョウタンノキの丸いヒョウタン
PWN:calcium.n.01	明るい炎を上げて燃焼する白色の金属元素
PWN:calculate.v.01	数学的演算や計算をする
PWN:calendar_month.n.01	暦年を12に分けた中の1つ
PWN:calendar.n.03	日にちの表配列（通常は1年間）
PWN:calf.n.01	家畜牛の若い
PWN:calf.n.02	筋肉でできたすねの裏側
PWN:californium.n.01	放射性の超ウラン元素
PWN:call_on_the_carpet.v.01	厳しくあるいは怒って避難する
PWN:call.n.01	電話接続
PWN:call.v.05	来るように指図、要求、または命令する
PWN:calm.a.02	（天気について）嵐または風がない
PWN:calm.s.01	扇動されない
PWN:camel.n.01	砂漠地域で役畜または乗用獣として使われる反芻動物
PWN:camp.n.03	郊外にある旅行者や行楽客のための一時的な泊まり場所
PWN:campfire.n.01	（キャンプなどで）暖を取ったり調理したりするための、小さな野外のたき火
PWN:can.n.01	真空密閉された金属容器で食物・飲み物・塗料などを入れる
PWN:canal.n.03	ボート、あるいはかんがい用に作られた、細長い水路
PWN:candle.n.01	中央に芯のある棒状の臘
PWN:canine.n.01	切歯と小臼歯の間に位置する4つのとがった円錐歯（各々のあごに2つある）のうちの1つ
PWN:cannon.n.01	通例車輪の付いた大きい銃
PWN:canoe.n.01	小型の軽いボート
PWN:canvas.n.01	重く目の詰んだ織り布
PWN:cap.n.01	ぴったりした頭飾り
PWN:cap.n.01	ぴったりした頭飾り
PWN:cape.n.01	水域に突出する細長い土地
PWN:capital.n.01	これからの資産形成に役立てられる資産
PWN:capital.n.03	政府の所在地
PWN:capitulation.n.03	降伏する（通常同意された状況下で）の行為
PWN:caprice.n.01	突然の欲望
PWN:capsicum.n.01	トウガラシをつけるトウガラシ属の種々の熱帯植物の総称
PWN:capture.v.01	漠然としたものを描写または表現できる
PWN:car.n.01	4輪の自動車
PWN:carbon.n.01	3つの同素形が存在する豊富な非金属の4価元素：非晶質炭素、石墨、およびダイヤモンド
PWN:carcase.n.01	特に屠殺され、食物とするために整えられた動物の死体
PWN:card.n.01	堅い紙の小片のセットの１つで、色々な印がつけられていて、ゲームをしたり、運勢を占ったりするのに使用される
PWN:card.n.04	たいてい長方形の、薄い板紙
PWN:care.n.01	誰かまたは何かに処遇を施したり、または注意を払うこと
PWN:caribou.n.01	雄雌両性とも大きな枝角を持つ北極鹿
PWN:carp.n.01	しばしば飼育される魚の脂肪の少ない肉
PWN:carpenter.n.01	木工品を作ったり修理したりする大工
PWN:carrot.n.01	栽培されているニンジン植物の濃いオレンジ色の食用の根
PWN:cartoon.n.02	矢継ぎばやに映されると動いている錯覚を与える一連のマンガを撮影することにより作成される映画
PWN:carve.v.01	彫刻により形成する
PWN:case.n.01	何かの発生
PWN:case.n.05	いくつかの物体を運ぶための持ち運び可能な容器
PWN:cashew.n.01	火を通すと食べられる腎臓型の堅果を持った、熱帯アメリカの常緑高木
PWN:cassava.n.01	キャッサバ植物の根っこをこして乾かすことで作られたでんぷん
PWN:cassava.n.02	乾燥し、洗脱した後に主食として食べられるキャッサバ根
PWN:cast.v.07	鋳型または型へ注ぐことで形作る（たとえば蝋または金属で）
PWN:cast.v.07	鋳型または型へ注ぐことで形作る（たとえば蝋または金属で）
PWN:castle.n.03	チェスの駒で、チェスボードのサイドに平行に駒のないマスをいくつでも動ける
PWN:castle.n.03	チェスの駒で、チェスボードのサイドに平行に駒のないマスをいくつでも動ける
PWN:cat.n.01	通常、厚く柔らかい毛皮を持ち、吠えることのできないネコ科の哺乳類：家ネコ
PWN:catastrophe.n.02	極度の（通常取り返しのつかない）崩壊と不運な状態
PWN:catch.v.04	動きを捕まえ、抑制し、止めるようにしっかりと押さえる
PWN:catcher.n.01	捕手のポジションでプレーする人
PWN:caterpillar.n.01	蠕虫状でしばしば明るい色で毛で覆われたまたはとげで覆われた蝶または蛾の幼虫
PWN:cattle.n.01	性別や年齢に関わらずグループとしての家畜化したウシ科の動物
PWN:cauliflower.n.01	たくさんの白い花の芽の大きな食用の頭頂部を持つ植物
PWN:cause.n.01	何かの起源である発生力を提供する出来事
PWN:cause.v.01	引き起こす
PWN:caution.n.01	用心深い特性
PWN:cave.n.01	地面の表面、または海からのアクセスのある地下の囲い地から成る地層
PWN:cavil.v.01	つまらないことに文句を唱える
PWN:ceiling.n.01	部屋の内側の頭上の裏張り
PWN:celebrated.s.01	広く知られ、尊重される
PWN:cellular_telephone.n.01	小さい区画に分割された地域で使う手で持てる大きさの移動ラジオ電話で、各区画は固有の短距離交換器／受信器をもつ
PWN:cemetery.n.01	埋葬に使用される一区画の土地
PWN:center.n.01	より大きなものの内部の、ほぼ真ん中にある領域
PWN:century.n.01	100年の期間
PWN:cerium.n.01	ランタン系列に属する、延性のある灰色の金属元素
PWN:certain.a.02	疑いまたは不確実性を持たないか感じないさま
PWN:certain.a.03	疑う余地なく疑いもなく立証された
PWN:certain.a.04	起こるのは、確実である
PWN:certain.s.01	明確だが、指定されていないあるいは特定されていない
PWN:certificate.n.01	述べられている事実が真実であることを証明する文書
PWN:cerumen.n.01	耳管の腺から分泌される柔らかで黄色い蝋
PWN:cesium.n.01	柔らかで銀灰色の延性のある金属元素（平温では液体で存在する）
PWN:chain.n.01	関連し合っているかのようにお互いに影響し合う一連の事柄
PWN:chain.n.03	（通例金属の）輪やリンクが互いにぴったりくっついて柔軟性のあるひもを形成する
PWN:chair.n.01	一人用の座席で、背もたれがある
PWN:chalk.n.01	柔らかくて白っぽい色をした方解石
PWN:chameleon.n.03	体色変化が可能な、飛び出す舌を持つアフリカ・マダカスカル産のトカゲ
PWN:champion.n.01	競技で優勝した人
PWN:change.v.01	変化させる
PWN:change.v.03	永久にそれかその前の特性か本質を失わずに何らかの特定の様子で異なるものになる
PWN:changeless.s.02	本質的に不変の
PWN:chapter.n.01	書物の一部分
PWN:character.n.08	言葉を表すために使われる書かれた記号
PWN:charcoal.n.01	空気のない中で、木や他の有機物質を加熱して得られる炭素質の物質
PWN:chart.n.01	情報のビジュアルな表示
PWN:cheap.a.01	価格が比較的低い、または安値で課金しているさま
PWN:check.n.01	銀行に払い出しを命じる証書
PWN:checkmate.n.02	相手のキングが、逃げられず、また防げないような攻撃となる一手
PWN:cheek.n.01	顔の下の目の側面のどちらか
PWN:cheese.n.01	凝乳を圧縮して固体状にした食物
PWN:chemical_element.n.01	それ以上単純な物質には分離できず、単独であるいは結合してあらゆる物を構成する、100を超える知られている物質（うち92は自然界に存在する）
PWN:chemical.n.01	原子または分子の変化を含む反応により生成される、また使われる物質
PWN:cherished.s.01	好きである愛情の感覚または、を示すことにより特徴づけられる
PWN:cherry.n.01	様々な桜の木、特にアメリカ桜の木材
PWN:cherry.n.03	硬い種がひとつ入った赤い果物
PWN:chess.n.02	2人のプレーヤーが特定のルールに従い、16の駒を動かすボードゲーム
PWN:chew_the_fat.v.01	多すぎる情報を交換し合うことなく、社会的に話す
PWN:chew.n.02	飲み込めるくらい柔らかくなるよう食べ物を口の中で噛み砕く
PWN:chew.v.01	咀嚼（食物）
PWN:chewing_gum.n.01	噛むための調製品（通常、甘く味付けられたチクルゴムからなる）
PWN:chicken_coop.n.01	飼鳥類用の農舎
PWN:chicken.n.02	肉または卵用に飼育される家禽
PWN:chief.s.01	最も重要な要素
PWN:child.n.01	両方の性別の若者
PWN:child.n.02	様々な年齢の人間の子供（息子あるいは娘）
PWN:chili.n.02	激辛で、特別な辛味をもつ、細くとがったコショウ
PWN:chimney.n.01	火からの煙が建物の壁または屋根を通じて運ばれる道を提供する縦の溝
PWN:chin.n.01	下顎の突き出た部分
PWN:china.n.01	東アジアで広大な領土を占める共産主義国
PWN:chinese.n.01	シナ・チベット語族の言語の総称で、中国で話される
PWN:chinese.n.02	中華人民共和国または中華民国の出身者、または、居住者
PWN:chisel.n.01	削いだ刃のある平たい金属の刃を持つ刃物
PWN:chlorine.n.01	ハロゲン族に属する、一般的な非金属元素
PWN:chocolate.n.02	焼かれた地面カカオ豆から作られた食物
PWN:choke.v.04	（誰かのもの）のどを収縮させて、呼吸しないようにする
PWN:cholesterol.n.01	通常肝臓によって合成される動物ステロール
PWN:choose.v.01	選ぶ、多くの選択肢から選ぶ
PWN:chop.v.01	細かく切られる
PWN:chop.v.01	細かく切られる
PWN:christianity.n.01	旧約聖書に基づいた信念と慣習、そして新約聖書で表現されたキリストの教えと、救世主としてのキリストの役割を強調した一神教の体制
PWN:christmas.n.01	12月24日から1月6日までの期間
PWN:chromium.n.01	硬くもろい多価金属元素
PWN:chrysanthemum.n.01	キクの花
PWN:church.n.01	キリスト教徒のグループで、彼ら自身の信仰を持ち、礼拝を形成した
PWN:church.n.02	市民（特にキリスト教徒の）崇拝の場所
PWN:cigarette.n.01	紙に包んだ細かく挽いたタバコ
PWN:circle.n.01	2本の軸が等しい長さである楕円
PWN:circle.n.03	円の形に近いもの
PWN:circumcision.n.03	割礼を施す行為
PWN:citizen.n.01	ある国、または、別の政治共同体に属する生来の、または、帰化した構成員
PWN:citizenry.n.01	州または国の一般人の集まり
PWN:citrus.n.01	厚い皮と果汁の多い果実を持つ柑橘類の多くの果物のどれか
PWN:city.n.01	大きくて人口密度が高い都市部
PWN:civilization.n.01	社会的発展（例えば法的、政治的、宗教的に複雑な組織を伴う）の先進の状態の社会
PWN:claim.n.01	（お金または財産に対するような）権利の主張
PWN:class.n.01	共通の属性を有する物の集まり
PWN:clavicle.n.01	肩甲骨と胸骨を結ぶ骨
PWN:claw.n.01	鳥、ある種の哺乳動物、または爬虫類の爪先の鋭い曲がった角質の突起
PWN:clay.n.01	湿っているときに可塑性であるが、熱せられると固くなるとても細かい土
PWN:clean.a.01	ほこりまたは不純物を含まない
PWN:clean.v.01	ほこり、汚物または不必要な物質を除去することできれいにする
PWN:clear.a.01	心を見ればすぐにわかる
PWN:clear.s.03	自由な通行または意見の余裕を持つさま
PWN:cleave.v.01	刃物などの道具で切り離す、または切る
PWN:cleave.v.01	刃物などの道具で切り離す、または切る
PWN:clemency.n.02	処罰を与える任にある人物や機関によって、犯罪者に対して示される寛大さや同情
PWN:cliff.n.01	岩の高くて急な斜面
PWN:climb.v.01	上向きにゆるやかであるか連続した進歩を伴う
PWN:cloak.n.02	ゆったりした外套
PWN:clock.n.01	時刻を示す時計
PWN:clog.v.01	妨げになる、または妨げられる原因になる
PWN:close.s.12	密接しているが心地よくなじんだ
PWN:close.v.01	入り口や通路を塞ぐように移動する
PWN:cloud.n.02	かなりの高度で浮遊している、目に見える水や氷の粒子が集まったもの
PWN:cloudy.s.03	（液体について）沈殿物を伴って濁る
PWN:club.n.02	類似の関心を持つ人々の公式な協会
PWN:club.n.03	一方の端がより大きくなっている頑丈な杖
PWN:coach.n.01	選手やチームの指導責任者
PWN:coal.n.01	石炭紀において堆積した炭化した植物質でなる化石燃料
PWN:coat.n.01	袖を持ち肩から下に向けて体を覆う外側の衣服
PWN:cobalt.n.01	硬質で強磁性の銀白色の2価または3価の金属元素
PWN:cobbler.n.01	靴を作ったり修理したりする人
PWN:cock.n.04	成長した雄のニワトリ
PWN:cockroach.n.01	非常に多くの主に夜行性の昆虫各種
PWN:cocoa.n.01	ココア粉とミルクと砂糖から作られる飲料
PWN:coconut.n.02	大きな堅い殻に入った卵形の木の実、繊維質の皮の中に厚い白い果肉で囲まれたうろがあり、（新鮮な場合）液体やミルクが詰まっている
PWN:cod.n.02	重要な北大西洋食用魚の脂肪の少ない白い肉
PWN:code.n.01	規則、原理、法のひとそろい（特に書かれたもの）
PWN:code.n.02	簡潔さか秘密主義を必要とするメッセージを送るのに使用される記号化体系
PWN:coffee.n.01	挽いたコーヒー豆の浸出液から成る飲料
PWN:cognition.n.01	知覚、学習、論理的思考の心理的な結果
PWN:coil.n.01	連続した輪で巻かれた何かで成る構造物
PWN:coin.n.01	（一般に円形）貨幣として使われる金属片
PWN:cold.a.01	低温、あるいは不十分な温度であること、または、寒いと感じること、または、例えば氷や冷凍で冷やされているさま
PWN:cold.a.01	低温、あるいは不十分な温度であること、または、寒いと感じること、または、例えば氷や冷凍で冷やされているさま
PWN:cold.n.01	鼻と呼吸器（肺を除く）に炎症を起こす軽症のウィルス性疾患
PWN:coldness.n.03	熱のないこと
PWN:collaborate.v.01	計画の共同作業を一緒にする
PWN:collar.n.01	首周りに合い、通常折り重なっているバンド
PWN:collar.v.01	保護する
PWN:color.n.01	それらが放つ、伝導する、あるいは反射する光によって生じる、物の目で見ることのできる属性
PWN:color.n.01	それらが放つ、伝導する、あるいは反射する光によって生じる、物の目で見ることのできる属性
PWN:colorful.a.01	刺激的な色を持つ
PWN:colt.n.01	4歳未満の若い雄馬
PWN:comb.n.01	平たい道具で、幅が狭くて先がとがった歯が片方の端についているもの
PWN:comb.v.01	櫛でまっすぐにする
PWN:comedy.n.01	ハッピーエンドの軽くユーモラスなドラマ
PWN:comfort.n.01	くつろいでいるか痛みを感じていない状態
PWN:command.n.01	何かをする正式の指示か命令
PWN:commend.v.01	認可を表明する
PWN:commiseration.n.01	人の不幸に対する同情と悲しみの気持ち
PWN:committee.n.01	ある問題について検討することを委ねられた特別のグループ
PWN:common_eel.n.01	成体として淡水にすむが、産卵するために海に戻るウナギ類
PWN:common_iguana.n.01	とげとげしたとさかが背中に沿ってある大きな草食の熱帯アメリカの樹上に住むトカゲ
PWN:common_sense.n.01	健全で実用的な判断
PWN:common.a.01	共通性により、概して属する、または共有された
PWN:communication.n.01	伝達する活動
PWN:community.n.01	共通の民族、文化、宗教的な特徴を持つ人々の集団
PWN:companion.n.01	しばしば別の仲間の中にいる友人
PWN:company.n.01	事業を行うために創設された機関
PWN:company.n.03	人と一緒にいること
PWN:compare.v.01	類似点または相違点を検討し留意する
PWN:compete.v.01	何かのために競う
PWN:complain.v.01	苦情、不満、不快または不幸を表現する
PWN:complete.v.01	仕上げるあるうは終わりにくるあるいはそれをもたらす
PWN:complex_number.n.01	aとbを実数、iを−1の平方根とした時のa＋biという形の数
PWN:complex.a.01	構造が複雑な
PWN:complimentary.s.02	何がかからないさま
PWN:component.n.03	合成実体が作られる個々の部品の1つである人工物
PWN:compromise.n.01	2つの極端の中間
PWN:compulsion.n.02	平凡な、または反復性の行動を意思に反しても行う際の、分別のない動機
PWN:computer.n.01	自動的に計算を行う機械
PWN:concede.v.01	認める（不正に）
PWN:conceive.v.03	妊娠状態になる
PWN:concern.n.02	心配な気持ち
PWN:concert.n.01	演奏家、歌手による演劇を含まない音楽の演奏
PWN:condition.n.01	一定の時の状況
PWN:condor.n.01	西半球で最大の飛ぶ鳥
PWN:cone.n.01	円錐形の人工品のいずれか
PWN:cone.n.02	基盤が円であり、側面がある程度先細りになる形
PWN:cone.n.03	円錐形の固まりである胚珠または胞子をつける鱗片または苞葉
PWN:coniferous.s.01	円錐形で常緑の葉をつける木または低木の、円錐形で常緑の葉をつける木または低木に関する、あるいは、円錐形で常緑の葉をつける木または低木の一部の
PWN:connect.v.01	2つ、それ以上のものをつなげる、固める一緒にする
PWN:connection.n.01	物事または出来事の関連（例えば1つがもう一方を引き起こす、あるいは1つがもう一方と共通点を持つ）
PWN:conscious.a.02	知っていることと知覚するさま
PWN:consequence.n.01	ある先行する現象に続く現象、またはある先行する現象を原因とする現象
PWN:conserve.v.02	安全に保ち、損害または腐敗、損失、破壊を防ぐ
PWN:consider.v.05	慎重に思い遣る
PWN:consist.v.04	構成された
PWN:consonant.n.01	母音でない音声
PWN:construct.v.01	材料および部品を合成して作る
PWN:consume.v.05	（資源または材料）使い果たす
PWN:container.n.01	ものを保持するために使用されることができる物の総称（特に一つの輸送手段から別のものに積み込まれることができる標準化された寸法の大きな金属の箱のような物）
PWN:contend.v.06	戦いに従事している
PWN:continue.v.01	特定の状態、条件または活動を続ける
PWN:continue.v.03	不変の状態に保つかまたは維持する
PWN:contract.n.01	2人以上の間の、法により実施できる拘束力のある協定
PWN:control.v.01	権威ある支配、または力を行使する
PWN:conventicle.n.02	（特にプロテスタント（例：クウェイカー教徒）の）宗教的集会用の建物
PWN:conversation.n.01	見解、考え、情報などの非公式な交換のための言葉の使用
PWN:converse.v.01	会談する、会話を続ける
PWN:convey.v.01	知らせる
PWN:convict.v.01	有罪であると裁定する、あるいは有罪であると宣言する
PWN:cook.v.01	温かい食事を用意する
PWN:cook.v.02	熱を加えることで食事を用意する
PWN:cook.v.03	暖めることで消費できる形に変える、にするあるいはにふさわしくする
PWN:cooked.a.01	加熱して、食事の準備をするさま
PWN:cookhouse.n.02	独立したまたは野外の料理用場所
PWN:cookie.n.01	小型で平らな甘い菓子
PWN:cool.a.01	暖かくもなくあまり冷たくもない
PWN:copper.n.01	延性順応性のある赤褐色の防腐反磁性金属元素
PWN:copy.n.02	別のものと同様、または同一になるよう作られたもの
PWN:cord.n.01	撚られた繊維あるいは糸で作られた線
PWN:cork.n.01	コルクガシの外側の樹皮
PWN:cormorant.n.01	魚をたくわえるために膨張性の袋を持つ大きく貪欲な暗い色をした長い首の海鳥
PWN:corn.n.01	大きい穂の上に実をつける背の高い一年生穀草：アメリカで多品種が広く栽培される
PWN:corner.n.03	2つの交差する壁で形成される内角
PWN:cornet.n.01	鮮やかなトーンのある金管楽器
PWN:corpulent.s.01	極端に太い
PWN:correct.a.01	エラーがない
PWN:correctly.r.01	正確な方法で
PWN:corrugated_iron.n.01	通例亜鉛メッキをした鉄板または鋼鉄板で真っ直ぐ平行なうねと中空に形作られている
PWN:cotton.n.02	綿繊維から織った織物
PWN:cotton.n.03	多くの長い毛のような繊維のある種を含む莢をつける直生のぼさぼさのゼニアオイ植物または小さな木
PWN:cough.v.01	人が胸部風邪または鬱血がある場合のように、急に息を吐き出す
PWN:count.n.01	数えられた総数
PWN:count.v.01	数か量を測定する
PWN:country.n.02	ある国が占有する領土
PWN:countryside.n.01	田舎の地域
PWN:courage.n.01	恐怖心を見せることなく、苦痛や危険に立ち向かうことのできる精神のある性質
PWN:court.n.01	司法業務を行うための集まり（1人以上の裁判官を含む）
PWN:court.n.08	法に基づいて裁判が行われている部屋
PWN:court.n.10	壁か建物によって完全に、または一部を囲まれた領域
PWN:cousin.n.01	おじやおばの子供
PWN:cover.v.01	カバーを供給するか、カバーされるようにする
PWN:cow.n.01	畜牛の雌
PWN:cowardly.a.01	勇気が欠如しているさま
PWN:cowbarn.n.01	牛用の納屋
PWN:coyote.n.01	北米西部原産の小型オオカミ
PWN:crack.n.01	細長い開口部
PWN:crack.n.01	細長い開口部
PWN:crack.n.04	突然の鋭い音
PWN:cradle.n.01	囲いと揺り子つきベビーベッド
PWN:crane.n.05	世界中の多くの場所にある沼地や平野にすむ長い首を持つ大型渉禽
PWN:crawl.v.01	ゆっくり動く
PWN:crawl.v.01	ゆっくり動く
PWN:cream.n.02	牛乳の脂肪を含む牛乳の重要成分
PWN:credit.n.05	商品やサービスに対する後払いの取り決め
PWN:crime.n.01	法律で罰せられる行為
PWN:crippled.s.01	足または足で使用不能である
PWN:crisscross.n.01	互いを横切る線から成る模様
PWN:crisscross.n.01	互いを横切る線から成る模様
PWN:crooked.a.01	湾曲または角を持つ、あるいはそれらによって特徴付けられるさま
PWN:crop.n.01	単一の生育期の植物からの収穫
PWN:crop.n.01	単一の生育期の植物からの収穫
PWN:cross.n.01	垂直に立った柱と横の棒から成る木の構造物
PWN:crow.n.01	耳障りな鳴声を持つ黒鳥
PWN:crowd.n.01	一緒になっていると見なされるたくさんの物や人
PWN:cry.n.01	けたたましい発言
PWN:cry.v.02	悲しみ、怒りまたは痛みのために涙を流す
PWN:cube.n.01	正6角形の面のある立方体
PWN:cuckoo.n.02	尖った翼に長い尾を持つ非常に多くの欧州・米国産の鳥類各種
PWN:cucumber.n.01	ククミス属のメロンつる
PWN:cucumber.n.02	薄い緑の皮と野菜として食される白い部分のある筒状で緑の果物
PWN:cucumber.n.02	薄い緑の皮と野菜として食される白い部分のある筒状で緑の果物
PWN:cultivate.v.02	作物の準備をする
PWN:culture.n.01	特定の時間と場所における特定の社会
PWN:culture.n.06	ある得べつの社会集団または組織に特徴的な態度や行動
PWN:cup.n.01	通常、飲酒に使用される小さいふたなし容器
PWN:cupboard.n.01	収納用に使われる小さな部屋（あるいは奥まった所）またはキャビネット
PWN:curassow.n.01	長い肢と尾を持つ南北アメリカの温帯地域にすむ大型でとさかのある樹上性の猟鳥
PWN:curiosity.n.01	何かについてもっと知りたいという状態
PWN:curium.n.01	放射性超ウラン金属元素
PWN:current.n.02	流体の一定の流れ（通常、自然発生のもの）
PWN:curse.v.03	危害を願う
PWN:curtain.n.01	日よけとして用いられる垂れ下がった布（特に窓のために）
PWN:curve.n.01	運動方向が変化する点の形跡
PWN:curved.a.01	カーブまたは滑らかに丸く曲がった角を持つ、に特徴付けられる
PWN:custom.n.01	受け入れられることまたは慣習
PWN:cut.v.01	器具であるいは器具を用いたかのように分ける
PWN:cycle.n.01	1つながりの出来事が再び起きるまでの間隔
PWN:cylinder.n.01	柱面と2つの平行した面（底面）に囲まれている固体
PWN:dam.n.01	水の流れを溜めておいたり海水を排除しておくために構築される防壁
PWN:damage.n.01	悪い方へ変化する出来事
PWN:damage.v.01	損害を与える
PWN:damp.s.01	わずかに湿った
PWN:dance.v.02	パターンのある動き
PWN:dandruff.n.02	頭皮からはがれ落ちた鱗状のもの
PWN:danger.n.01	傷ついたり危害を受けやすい状況
PWN:dangerous.s.02	大きな危害を脅かすことにより恐れまたは不安を引き起こすさま
PWN:dare.v.02	何かを試みる、または出来るほど勇敢な
PWN:dark.a.01	光または明るさが欠けている、または、光または明るさが不十分な
PWN:dark.n.01	光または照明の欠如
PWN:darmstadtium.n.01	放射性超ウラン元素
PWN:date.n.01	月の特定の日
PWN:date.n.08	単一の長い木質の種子のあるナツメヤシの甘い食用の実
PWN:daub.v.03	それに（物質）を塗ることにより（表面を）カバーする
PWN:daughter.n.01	女性の子供
PWN:dawn.n.01	日の出
PWN:day.n.01	地球が地軸の周りを完全に1周する時間
PWN:day.n.05	寝ていないとき繰り返される時間（特に、働いている時間）
PWN:dead.a.01	生命がもはやない、ないように見えるまたはないと期待される
PWN:deaf.a.01	聴覚の全て、または一部がないこと、あるいは奪われる
PWN:deaf.n.01	深刻な聴覚障害を持つ人々
PWN:death.n.01	死ぬことやこの世から旅立つこと
PWN:debate.v.01	お互いに議論する
PWN:debate.v.03	問題の賛否両論について議論ずる
PWN:debt.n.01	何か（特に金銭）を借りている状態
PWN:debt.n.02	ある人から別の人に借りられたお金、商品、またはサービス
PWN:decade.n.01	10年間
PWN:deceive.v.01	いんちきである
PWN:december.n.01	1年の最後（12番目）の月
PWN:deception.n.02	欺く行為
PWN:decide.v.01	何かについての決定に達する、実行する、に至る
PWN:decide.v.02	終わりをもたらす
PWN:deck.n.01	船に装備される様々な平甲板
PWN:deck.n.04	船のデッキに似ているポーチ
PWN:decompose.v.03	崩壊する
PWN:decorate.v.01	飾り、色などを追加することによってより魅力的にする
PWN:decoration.n.01	美しくするために用いられるもの
PWN:decrease.v.01	サイズ、または範囲を縮小する
PWN:deep.a.01	比較的深い、または強いさま
PWN:deep.a.03	外部表面、後ろ側、中心からの側面あるいは外側から大きな空間の拡張、下方侵入、あるいは内部進入を有するさま
PWN:deer.n.01	オスが固い脱落性の枝角を持つ点でウシ科と区別される
PWN:defeat.n.01	争い、またはか競争の不成功の結末
PWN:defect.n.03	物または機械の欠陥
PWN:defend.v.03	挑戦または攻撃から保護する
PWN:defendant.n.01	裁判所で訴訟を起こされる人か団体
PWN:deft.s.01	身体的な運動に熟練した
PWN:defy.v.01	抵抗するか、抵抗に立ち向かう
PWN:degree.n.01	強さまたは量または品質の階級の位置
PWN:deity.n.01	超自然的存在で、世界のある地域または人生のある場面を支配するとして、または、力の化身であるとして崇拝されるもの
PWN:delay.v.01	減速させられる、または遅延させられる
PWN:delicate.s.03	容易に壊されるか、または傷つけられるか、または破壊される
PWN:delightful.s.01	大いに喜ばせるかまたは楽しませるさま
PWN:demonic.s.01	極端に悪いまたは残酷な
PWN:dense.s.03	高い相対密度、あるいは比重を持っているさま
PWN:density.n.01	単位大きさあたりの量
PWN:dent.n.03	（強打によってできたような）表面の痕跡
PWN:deny.v.04	所有させることを拒む
PWN:depart.v.03	出発する
PWN:depend.v.01	（削除されたもの）次第である
PWN:depository_financial_institution.n.01	預金を受け付け、その金を貸付業務に回す金融機関
PWN:depression.n.01	力量不足であるという悲観的な感情と、非活動的な意気消沈が特徴の精神状態
PWN:depth.n.01	下方、後方、または、内部への範囲
PWN:descend.v.01	下と低い方へ向かうが、必ずしもずっと行かない
PWN:descendants.n.01	ある先祖のすべての子孫
PWN:describe.v.01	描写を行う
PWN:desert.n.01	植物がほとんど、あるいはまったくない不毛の地域
PWN:deserve.v.01	それにふさわしい、あるいはそれに値する
PWN:desire.n.01	満たされていない状態を伴う気持ち
PWN:desire.n.01	満たされていない状態を伴う気持ち
PWN:desire.v.01	それへの欲求を感じる、または持つ
PWN:desk.n.01	書き物をする面と、通常引き出しまたはその他の仕切りがついた家具
PWN:destiny.n.01	未来に必ず起きること（または事の成り行き）
PWN:destroy.v.01	処分する、破壊あるいは破滅を引き起こす
PWN:destroy.v.02	撃滅する
PWN:detail.n.01	全体から分離して考えられる独立した事実
PWN:detainee.n.01	拘留されている人
PWN:detect.v.01	生存、存在または、の事実を発見するまたは断定する
PWN:devil.n.02	邪悪な超自然的な存在
PWN:dew.n.01	大気中の水蒸気が一晩のうちに冷えた表面で凝固した水
PWN:diagonal.s.01	平面図形の2つの非隣接角あるいは同じ表面にない立体の2つの角いずれかを接続するさま
PWN:dial.n.01	時計の文字盤
PWN:diarrhea.n.01	頻繁で水っぽい排便
PWN:diary.n.01	（普通個人的な）経験と観察の毎日書かれる記録
PWN:dictator.n.01	秘書または記録機械に口述する話者
PWN:dictator.n.02	法に拘束されない支配者
PWN:dictionary.n.01	単語に関する情報が載っている単語のアルファベット順のリストを含む参考図書
PWN:die.v.01	物理的な生きている状態から去り、生命を維持するのに必要なすべての身体上の属性と機能を失う
PWN:different.a.01	本質、性質、形体または程度において同様でない
PWN:difficult.a.01	簡単でない
PWN:diffident.a.02	自信がないさま
PWN:dig.v.01	地をひっくり返す、緩ませる、あるいは取り除く
PWN:digest.v.03	不快な何かまたは誰かを我慢する
PWN:dining_room.n.01	食事用に用いられる部屋
PWN:dining.n.01	食事をする行為
PWN:dinner.n.01	夕方、または正午にとる1日の主要な食事
PWN:diplopoda.n.01	2組の脚を持つさまざまな二重体節で成るからだを持つ節足動物：ヤスデ
PWN:direct.a.01	空間次元に向かっている
PWN:direction.n.01	ある場所や点へ向かう線
PWN:direction.n.02	それが指すか、動く何かに沿う方向の空間的関係
PWN:dirt.n.02	清潔でない物に覆われている状態
PWN:dirty.a.01	汚れまたはほこり汚れたまたは汚れるような
PWN:dirty.v.01	汚す、不潔にする、または不浄にする
PWN:disappear.v.01	道に迷う、警告あるいは説明なしで
PWN:disappointment.n.01	期待が実現されないときに生じる不満感
PWN:disapprove.v.02	間違っているか不適当であると考える
PWN:disclosure.n.01	何かを明白にする言語行為
PWN:discontinue.v.01	状態または活動に終止符を打つ
PWN:discontinue.v.01	状態または活動に終止符を打つ
PWN:discourse.v.01	スピーチまたは文章で熟慮するまたは調査する
PWN:disease.n.01	健康障害もしくは、機能異常の状態
PWN:dish.n.01	通常食べ物を乗せたり出したりするのに用いる食器の1つ
PWN:disk.n.01	平らな円形の皿のような丸い形のもの
PWN:dislike.v.01	反感、または嫌悪を持つか、感じる
PWN:disobey.v.01	同調するすることを拒む
PWN:disperse.v.02	分離させるまたは異なった方向へ行く
PWN:disquieted.s.01	気がかりな不安、トラブルまたは悲しみに苦しめられるまたは、それらに特徴付けられる
PWN:disregard.n.01	注意や当然と思われる関心が欠如していること
PWN:dissolve.v.08	溶体になる
PWN:dissolve.v.09	やわらかくまたは液状になる、またはそのように仕向ける
PWN:distance.n.01	2つの物や点の間の空間によって作り出される特質
PWN:distance.n.03	2つの場所の間の大きさ
PWN:distinguish.v.01	異なっていると強調される
PWN:ditch.n.01	地面に開いた長く狭い穴
PWN:dive.v.03	水中で泳ぐ
PWN:divide.v.01	部分や部分に分かれる
PWN:divide.v.02	分割を実行する
PWN:divorce.n.01	結婚の法的解消
PWN:doctor.n.01	認可された医者
PWN:document.n.01	情報を提供する文書（特に公式自然の情報）
PWN:dog.n.01	有史以前から人間に家畜化されて来た（おそらく普通のオオカミを先祖とする）イヌ属の動物
PWN:doll.n.01	人の小さいレプリカ
PWN:dolphin.n.02	くちばしのような鼻先を持つ様々な小型歯クジラ各種
PWN:dome.n.01	凹面が下方向を向いていることを特徴とする凹型
PWN:domestic_ass.n.01	アフリカの野生のロバを先祖に持つ荷運び用の家畜獣
PWN:domestic_fowl.n.01	セキショクヤケイに由来すると考えられる家畜化されたキジ目の鳥
PWN:donate.v.01	慈善団体または立派な大義名分に与える
PWN:door.n.01	部屋または建物または車の入り口を閉鎖するだろう揺れるかまたは滑っている柵
PWN:doorjamb.n.01	ドアのための柱
PWN:doubt.n.01	何かについて確信がない状態
PWN:doubt.v.02	に対して自信がない、あるいは疑いがある
PWN:dough.n.01	こねたり巻いたりできるくらいに堅くといた小麦粉の混合物
PWN:dove.n.01	非常に多い小型のハト類各種
PWN:down.r.01	空間的にまたは比喩的に高いレベルあるいは位置から低い位置へ
PWN:drag.v.01	引く、抵抗に対して
PWN:dragon.n.01	チュートンの神話の生き物
PWN:dragonfly.n.01	休息中は虹色の羽を広げるほっそりした体の刺さない昆虫
PWN:drain.n.03	液体が運び去られる管
PWN:drama.n.03	劇場向けの文学作品のジャンル
PWN:draw.v.07	容器か井戸から液体を取り出す
PWN:dream.n.01	睡眠中に起こる一連の精神的イメージと感情
PWN:dream.v.02	寝ている間に経験する
PWN:dress.n.01	婦人用のワンピース
PWN:dress.v.01	衣服を身に着ける
PWN:drill.n.01	固い材質のものに穴を開けるための、先の尖った切り刃をもつ道具（通例素早く回転したり、連続的に打ち付けたりして）
PWN:drink.v.01	液体を中に入れる
PWN:drip.n.01	滴になって流れる
PWN:drip.v.01	ポツポツ落ちる
PWN:drive.v.01	乗り物を操作するかコントロールする
PWN:drive.v.03	運転することにより誰かまたは何かを引き起こさせる
PWN:drive.v.15	前進するように促す
PWN:drivel.v.01	口からよだれを出しておく
PWN:driver's_license.n.01	車を運転することを所持者に許可する免許証
PWN:drop.n.01	球状で小さい形
PWN:drop.v.01	地面へ落とす
PWN:droppings.n.01	動物の糞便
PWN:drove.n.02	動く群集
PWN:drown.v.03	水中に沈められたことにより、肺の中に水が入り込み、窒息して死ぬ
PWN:drown.v.03	水中に沈められたことにより、肺の中に水が入り込み、窒息して死ぬ
PWN:drum.n.01	打楽器
PWN:dry_season.n.01	熱帯の気候の2つの季節のうちの1つ
PWN:dry.a.01	液体または湿気がない
PWN:dry.v.01	湿気を除去して、乾かす
PWN:dry.v.01	湿気を除去して、乾かす
PWN:dubnium.n.01	超ウラン元素
PWN:duck.n.01	野生または飼い慣らされた遊泳性の小さな鳥で、たいてい平たい体に短い肢を持ち、肢には水掻きが付いていて、くちばしは幅広い
PWN:dull.a.01	生き生きとしたさま、または活気を欠いているさま
PWN:dull.a.09	鋭い縁または先端を持たない
PWN:dumb.s.04	遺伝的な聴覚障害のため話すことができない
PWN:dunk.v.01	少しだけある液体に浸すことで湿らせ、覆い、しみこさせる
PWN:durable.s.01	長い間存在するさま
PWN:durable.s.02	消耗と腐敗に耐えることができる
PWN:duration.n.01	何かが連続する時間
PWN:dust.n.01	乾いたや花粉など、大気中のあちこちを吹き飛ばされる細かな粒子状の物質
PWN:duty.n.01	あなたをその力によって要求された行動方針に結びつける社会的勢力
PWN:dye.v.01	染料により色をつける
PWN:dysprosium.n.01	希土類の3価の金属元素
PWN:each.s.01	（可算名詞に使用される）個々に考えられるそれぞれ
PWN:eagle.n.01	それらの大きな翼と強く急上昇する飛行で有名な非常に視力の良い昼行性の様々な大きな猛禽類のいずれか
PWN:ear.n.01	聴覚と平衡感覚のための感覚器官
PWN:earlier.r.01	時間的に前の
PWN:earlier.r.01	時間的に前の
PWN:earlobe.n.01	人間の外耳の肉の垂れ下がった部分
PWN:early.r.03	余裕をもって
PWN:earnest.s.01	あなたの意見の正当性についての堅くユーモアのない考えによって特徴づけられる
PWN:earring.n.01	耳を飾る宝石
PWN:earth.n.01	太陽から3番目の惑星
PWN:earthquake.n.01	火山活動により断層面に沿った地下運動によって、地球の表面が揺れて震動すること
PWN:east.n.01	90度を指す基本的な羅針盤方位
PWN:easter.n.01	キリストの復活を祝う、キリスト教の祝賀
PWN:eat.v.01	固形食物を取り入れる
PWN:eclipse.n.01	1つの天体がもう一つのものを暗くする
PWN:economical.s.03	無駄を避ける
PWN:edge.n.01	表面の境界
PWN:edge.n.06	物、面積または表面の外側の制限
PWN:egg_yolk.n.01	卵白で囲まれた黄色い球形の部分
PWN:egg.n.01	滋養と防御の包膜を持つ卵、もしくは胎児も一緒の物から成る動物生殖体
PWN:egg.n.02	食物として使用される鶏の楕円形の生殖体（特にめんどりの）
PWN:egypt.n.01	1971年までアラブ連合共和国として知られていたアフリカ北東部の共和国
PWN:eight.s.01	7よりも1多い
PWN:eighty.s.01	70よりも10多い
PWN:einsteinium.n.01	プルトニウムに中性子で衝撃を与えると生じる、放射性の超ウラン元素
PWN:elapse.v.01	過ぎ去る
PWN:elastic.a.01	伸長たまたは圧縮の後に最初の形に復旧することができるさま
PWN:elbow.n.01	前腕と上腕の間にあり、四肢動物の前肢にある関節に相当する蝶番関節
PWN:elect.v.01	投票で官職または会員を選択する
PWN:election.n.01	政治的職務を得る人を選ぶ投票
PWN:electricity.n.01	静止したあるいは動いている電子と陽子に関連した物理的現象
PWN:electricity.n.02	導体を通じる電荷の流れによって可能なエネルギー
PWN:elementary.s.01	簡単である、そして、かかわっていない、または複雑ではない
PWN:elephant.n.01	5本足指の厚皮動物
PWN:elevator.n.01	垂直シャフト中を機械的に上昇降下する台またはケージで人を建物のある階から別の階へと運ぶためのもの
PWN:eleven.s.01	もの10以上多いさま
PWN:elf.n.01	ちょっといたずら好きな妖精
PWN:elf.n.01	ちょっといたずら好きな妖精
PWN:elk.n.01	巨大な平らな枝角がオスにある大きな北の鹿
PWN:ellipse.n.01	円錐と、円錐を完全に横断する平面との交差によってできる平面の閉曲線
PWN:elm.n.01	ニレ属の様々な木の総称：重要な材木あるいは緑陰樹
PWN:elongate.v.01	引いたり伸ばしたりして長くする、またはより長くする
PWN:embarrassment.n.01	不適格であるまたは罪悪が公共の場でなされたときに感じる恥
PWN:ember.n.01	たき火の後に残る、燃えているかくすぶっている熱い木片あるいは木炭のかけら
PWN:embrace.v.02	通常、愛情表現で腕に（人を）きつく抑える
PWN:emerge.v.01	視界に入れる、隠匿から
PWN:emit.v.02	放つか、送るか、または排出する
PWN:employment.n.02	報酬をもらっている仕事
PWN:empty.a.01	何も持たないか、含まないさま
PWN:enchantress.n.02	女性の魔法使いや魔術師
PWN:enchantress.n.02	女性の魔法使いや魔術師
PWN:end.n.03	事件や出来事の結末の部分
PWN:end.n.09	何かの極限を示す境界
PWN:end.v.01	一時的か、空間か、量的感覚に、終わりがある
PWN:endowment.n.01	天賦の才または特性
PWN:enemy.n.02	武装した相手（特に対立する軍事力の一員）
PWN:energy.n.01	動作する物理的システムの容量と同等の熱力学量
PWN:enough.r.01	必要なだけ
PWN:enter.v.01	来るまたは中に入る
PWN:enthuse.v.01	熱意を感じる原因
PWN:enthusiasm.n.01	興奮した気持ち
PWN:entirely.r.02	含まれるまたは関係する他のものなしで
PWN:entrance.n.01	出入りを提供するもの（入る、または、出る）
PWN:envelope.n.01	手紙、細いパッケージ、などのための平らな（通常長方形の）容器
PWN:environment.n.02	何かが存在、あるいは住んでいる場所
PWN:envy.n.01	人の物を恨みっぽく賞賛して欲すること
PWN:equal.a.01	もう一方と同じ量、価値、または測定値であるさま
PWN:erbium.n.01	希土類の三価の金属元素
PWN:erstwhile.s.01	ある事前の時間に属する
PWN:escape.v.01	監禁から逃げる
PWN:estimate.v.01	とりあえず判断するまたは、の予想を立てる（量または時間）
PWN:ethnic_group.n.01	特有の文化を共有する、同一の人種や国籍の人々
PWN:european.n.01	ヨーロッパの出身者、または、居住者
PWN:europium.n.01	希土類の2価および3価の金属元素
PWN:evaluate.v.02	批判的な意見を形成する
PWN:evaporate.v.01	蒸発で水分を失うまたは失うようにすることでより濃度の濃い残余を残す
PWN:even.a.03	例えば、形またはテクスチャーのように変化を伴わず水平である、直線であるあるいは規則的であるさま
PWN:evening.n.01	1日の後半（午後遅く日が落ちてから夜まで）
PWN:ever.r.01	いかなる時でも
PWN:evil.a.01	道徳的に悪い、または間違っているさま
PWN:ewe.n.03	雌の羊
PWN:exact.a.01	事実にきっちりと完全に一致する特徴がある
PWN:example.n.01	ある階級または集団の典型とされる情報の物
PWN:excessively.r.01	通常であるか適当な限度を上回っている
PWN:exchange.v.01	互いに与える、また受け取る
PWN:exclaim.v.01	大声で発声する
PWN:exercise.n.01	健康を維持するための様々な方法での筋肉の鍛錬
PWN:exercise.n.03	何度も繰り返すことによる体系的な訓練
PWN:exist.v.01	存在を持つ、存在する
PWN:exit.v.01	出て行く、または立ち去る
PWN:exit.v.01	出て行く、または立ち去る
PWN:expand.v.01	1つまたはそれ以上の方向に伸ばす
PWN:expect.v.01	何かに対して、起こり得る、または見込まれると見なす
PWN:expensive.a.01	値段が高い、または高い値段で請求する
PWN:experience.v.01	経る、あるいは乗り切る
PWN:experiment.n.01	管理された試験または調査を行う行為
PWN:explain.v.01	平易で理解可能にする
PWN:explode.v.01	エネルギーの猛烈な放出を伴う破裂を起こす
PWN:extend.v.04	入手可能にする
PWN:extinguish.v.04	終わらせるか、途切れさせるか、取り除く
PWN:extraneous.s.03	自制しているそれに属していない
PWN:exuberate.v.01	大きな喜びを示す
PWN:eye.n.01	視覚器官
PWN:eyebrow.n.01	それぞれの目より上にある髪のアーチ
PWN:eyelash.n.01	まぶたの縁から生える短い湾曲した毛の総称
PWN:eyelid.n.01	眼を閉じたり、開けたりするときに動く皮膚のひだ
PWN:fabric.n.01	天然繊維あるいは合成繊維を織ること、フェルトにすること、編むこと、または鉤針編みすることによって作られる人工物
PWN:face.n.01	額から顎、耳から耳までの人頭の前部
PWN:fact.n.01	実存する状況、または発生した出来事についての情報
PWN:factory.n.01	製造のための施設のある1つかそれ以上の建物で成る工場
PWN:fail.v.01	ある事をしない
PWN:fail.v.03	失望させ頼れないことを証明する
PWN:faineant.s.01	仕事または骨の折れる仕事に対してやる気が起こらない
PWN:fair.a.01	偏愛、利己心、偏り、詐欺とは無縁の
PWN:fairy.n.01	小さな人間の形で、遊び好きで魔力をもつ
PWN:fairytale.n.01	妖精についての物語
PWN:faithful.a.01	愛情または忠誠でしっかりとした
PWN:fall_asleep.v.01	起きている状態から寝ている状態へ変化する
PWN:fall.n.01	落葉する季節
PWN:fall.v.01	重力の影響を受けている時、歯止めなく落下する
PWN:fall.v.23	突然、直立姿勢を失う
PWN:false.a.01	事実、現実または現実性に従ってではなく
PWN:familiar.a.01	よく知られているか、または容易に認識される
PWN:family.n.02	主要な社会グループ
PWN:famine.n.02	激しい飢えと飢餓と死をもたらす（収穫不作を通した）厳しい食糧難
PWN:fan.n.01	1つ以上の面を動かすことで空気の流れを作る装置
PWN:fan.n.01	1つ以上の面を動かすことで空気の流れを作る装置
PWN:fan.v.03	空気を扇動する
PWN:fanciful.s.02	事実に基づいていないさま
PWN:far.a.01	時間、スペース、程度において非常に距離がある
PWN:far.r.02	空間において遠くで、遠くへ、または遠くから
PWN:faraway.s.01	空間または時間においてとても遠い
PWN:farm.n.01	農場の建物および耕地を一体にしたもの
PWN:farmer.n.01	農場を経営する人
PWN:fart.v.01	肛門を通じて腸内のガスを出す
PWN:fashion.n.04	最新のモードの消費財（とくに洋服）
PWN:fast.r.01	迅速に、または急速に
PWN:fast.v.01	宗教的、または医学的理由などで特定の食物を控える
PWN:fast.v.01	宗教的、または医学的理由などで特定の食物を控える
PWN:fat.n.01	有機的な組織で起こって、脂質の混合物から成る軟質の油性物質（ほとんどトリグリセリド）
PWN:fat.s.05	大きな有効性で特徴付けられる
PWN:father-in-law.n.01	配偶者の父親
PWN:father.n.01	男親（父親の呼称としても使われる）
PWN:fatherland.n.01	あなたが生まれた国
PWN:fathom.n.01	水深の度量衡の線形測定単位（6フィートと同じ）
PWN:faucet.n.01	貯水池からの液体の流れを制御する、調節装置
PWN:fault.n.06	悪い状況や出来事に対する責任
PWN:faulty.s.02	誤りで特徴づけられる
PWN:fear.n.01	特定の苦痛または危険を察した時の感情（通常、逃避または戦いを望む感情を伴う）
PWN:fear.v.01	ありそうな、または可能性のある状況や出来事について恐れている、心配または不安を感じる
PWN:feather.n.01	鳥の外側の覆いを形成する、軽くて角質の防水構造物
PWN:february.n.01	1月に続いていて、3月に先行している月
PWN:fecal_matter.n.01	腸から排出された固体状の排泄物
PWN:feed.v.01	食物として提供する
PWN:feel.v.03	例えば皮膚か筋肉から伝わるなどの身体的感覚によって知覚する
PWN:feel.v.09	触って調べる
PWN:feeling.n.01	感動の、感情的な状態を経験すること
PWN:feign.v.01	だます意図でふりをする
PWN:felt.n.01	圧縮された平たい動物の繊維でできた布地
PWN:female_child.n.01	若々しい女の人
PWN:female.a.01	受精できる配偶子（卵子）を生産し、子孫が発育する性別であること（植物か動物の）
PWN:female.s.03	女性または少女のための、に関係していること、あるいはを構成しているさま
PWN:fence.n.01	ある領域を囲うための障壁
PWN:fermium.n.01	放射性の超ウラン金属元素で、プルトニウムに中性子で衝撃を与えると生じる
PWN:festival.n.01	祝宴と祝賀のためにとっておいた日または時間
PWN:fetid.s.01	不快に臭い
PWN:fetus.n.01	発達段階における胎児、または卵からかえっていない脊椎動物で、成熟した動物を認識できる形をしている
PWN:fever.n.01	身体の体温が上がること
PWN:few.a.01	可算名詞と共に使用できて、しばしば'a'によって先行されている数量詞
PWN:fiction.n.01	想像に基づき、必ずしも事実に基づいていない文学作品
PWN:field_hockey.n.01	フィールドで行われるアイスホッケーに類似しているゲーム
PWN:field.n.01	木を取り払った、通常囲われた土地
PWN:fifteen.s.01	14よりも1多い
PWN:fifty.s.01	40よりも10多い
PWN:fig.n.02	食用に適する果実のために広く栽培される地中海の高木
PWN:fig.n.04	生または保存され、乾燥させられて食べられる肉質の甘く梨のような形をした黄色っぽい、あるいは紫の多花果
PWN:file.n.01	ともに保管される関連した（書かれたものまたは電子的なもの）記録の一式
PWN:file.n.04	鋼鉄製の手道具でいくつかまたは全部の面に鋭い歯が付いている
PWN:fill.v.01	比喩的な感覚においても、いっぱいにする
PWN:film.n.04	薄い被膜または層
PWN:fin.n.06	魚や他の水生動物の移動やバランス用の器官
PWN:finally.r.01	不特定の期間か特に長い遅れの後に
PWN:find.v.03	探した後で次に来る
PWN:fine-looking.s.01	形体と比率の理想への調和による見かけ上の心地よさ
PWN:fine.a.05	触覚が滑らかな織地または比較的小さい粒子から成る物質の
PWN:fine.n.01	罰金として引かれる金銭
PWN:finger.n.01	手の末端の器官（時に親指を除く）
PWN:fingernail.n.01	指の末端にある爪
PWN:finish.n.04	終わり（レースまたは旅行現在）に指定される場所
PWN:fir.n.02	トドマツ属の常緑高木の総称
PWN:fire.n.01	何かが燃えること（たいてい破壊的）
PWN:fire.n.03	熱や発光、（時には）煙を出しながら可燃性の物質が燃える過程
PWN:fire.n.03	熱や発光、（時には）煙を出しながら可燃性の物質が燃える過程
PWN:fireplace.n.01	火をおこすことができる、煙突の土台の壁に開いたくぼみ
PWN:firewood.n.01	燃料用の木材
PWN:firm.s.02	柔らかくないか圧力に屈さない
PWN:first.a.01	時間、空間、または程度について他のすべてに先行する
PWN:first.r.02	初回
PWN:first.s.02	連続するものにおいて初めの単位を示すさま
PWN:fish_cake.n.01	魚の薄片・マッシュポテトの揚げ団子やパテ
PWN:fish.n.01	通常は鱗を有し、鰓を通して呼吸する、ほとんどが冷血の様々な水生脊椎動物の総称
PWN:fish.v.02	魚または貝をつかむか、またはつかまえようとする
PWN:fisherman.n.01	魚を捕まえる職業の人
PWN:fishhook.n.01	魚を釣るための刺のある針
PWN:fishing_line.n.01	リーダ・浮き・錘・釣針が付けられる、ある長さの糸
PWN:fishnet.n.01	引っ張ると魚が閉じ込められるようになった網
PWN:fist.n.01	指を手のひらにぎゅっと握りしめた手（殴るためのように）
PWN:five.s.01	4よりも1多い
PWN:fix.v.12	特定の目的、使用、あるいは出来事のためにあらかじめ準備しておく、整える、備える
PWN:flag.n.01	通常は特徴的なデザインをした長方形の布地で成るエンブレム
PWN:flag.n.04	信号伝達に使う長方形の布
PWN:flame.v.02	炎の中にあるか、燃えている
PWN:flash.v.01	断続的に輝く
PWN:flat.s.01	斜面のない表面を持つこと、一部分がもう一つより高くないまたは低くない傾斜
PWN:flat.s.01	斜面のない表面を持つこと、一部分がもう一つより高くないまたは低くない傾斜
PWN:flavorer.n.01	食物に主に風味を加えるためのもの
PWN:flax.n.02	種子と茎の繊維のために耕作されるアマ属の植物
PWN:flay.v.01	皮膚をはぎ取る
PWN:flea.n.01	羽無し吸血寄生虫で、跳躍する能力で知られる
PWN:flee.v.01	すばやく逃げ出す
PWN:flesh.n.01	脊椎動物の身体の柔らかい組織：主として筋肉組織と脂肪
PWN:flex.v.05	（可塑性の物）を曲がった、あるいは角ばった形にする
PWN:flexible.a.01	変わることができる
PWN:flexible.a.02	曲げることができるさま
PWN:flip.v.06	軽く投げる、あるいぽいと放る
PWN:flip.v.08	逆さにするまたは反対になるように投げる
PWN:float.v.01	微風または水流によって動いている
PWN:float.v.01	微風または水流によって動いている
PWN:float.v.02	液体の表面、あるいはその下のどちらかで浮かび、底に沈まない
PWN:flood.n.01	水域が上昇し、通常は陸地である場所に溢れること
PWN:floor.n.01	（部屋、廊下、テント、またはその他の建造物の）内側の、下側の水平面
PWN:flour.n.01	シリアル粒の食物をつぶすまたはふるうことで得られる細かい粉状の食料品
PWN:flow.v.01	流れにいるかのように自由に動き前進する
PWN:flower.n.02	被子植物の生殖器官で特に目立ったり、あるいはカラフルな部分を持つもの
PWN:fluid.s.02	流体の特性
PWN:fluorine.n.01	ハロゲンに属する非金属の一価元素
PWN:flute.n.01	高音の木管楽器
PWN:fly.n.01	活発な飛行活動によって特徴づけられる2翼の昆虫
PWN:fly.v.01	空気中を移動する
PWN:foam.n.01	液体中あるいは液体上にできた小さな泡の塊
PWN:foe.n.02	個人的な敵
PWN:fog.n.01	地上近くの大気中に浮遊している水蒸気の水滴
PWN:fold.n.06	羊用囲い
PWN:fold.v.01	一つの部分が他の部分を覆うように曲げるあるいは置く
PWN:follow.v.01	後ろを行き、後を追い、後に来る
PWN:following.s.02	直ちに時間あるいは命令に続くさま
PWN:food.n.01	エネルギーを与え、組織を形成するために動物が代謝する物質
PWN:food.n.02	栄養物として用いられる固形物質（液体に対するものとして）
PWN:fool.n.01	分別に欠ける人
PWN:foolish.a.01	良識か判断力に欠けている
PWN:foot.n.01	足首関節の下の人の脚の部分
PWN:football.n.01	ボール（丸または楕円）を用いる様々なゲームで、2つの相対するチームが互いのゴールにそのボールを蹴り込んだり、運び込んだり、押し込んだりする
PWN:footing.n.02	何かの土台となるものを与えてくれる関係
PWN:footprint.n.01	表面にできる足または靴の跡
PWN:forbid.v.01	反対する命令を出す
PWN:forbid.v.01	反対する命令を出す
PWN:force.n.01	強い影響力
PWN:force.n.02	物理量に変化を生じさせる影響
PWN:foreman.n.01	労働者の管理をする人
PWN:forest.n.01	広く木々の密生した地域の高木やその他の植物
PWN:forge.v.01	鍛造により作り出す
PWN:forget.v.02	覚えていることができない
PWN:forgive.v.01	非難することをやめるまたは許しを与える
PWN:fork.n.01	食べ物を出して食べるのに使用する食卓用刃物類
PWN:fork.n.03	2つの枝路の分岐点が形成する角の領域
PWN:form.n.03	知覚の構造
PWN:fortress.n.01	とりでで固めた防御構造
PWN:forty.s.01	30よりも10多い
PWN:forward.r.01	正面で、正面に、または、正面に向かって
PWN:four.s.01	3よりも1多い
PWN:fox.n.01	とがった鼻、耳と毛の多い尻尾を使って注意深い肉食の哺乳類
PWN:foxtail.n.01	密集した、滑らかまたは剛毛質の筆のような花のつく穂状花序を持つ、スズメノテッポウ属とエノコログサ属
PWN:fragrant.a.01	香の良い
PWN:frame.n.01	眼鏡にための枠組み
PWN:framework.n.03	何かを支える、あるいは保持する構造物
PWN:francium.n.01	アクチニンの分解物として存在するアルカリ金属類の放射性元素
PWN:free.a.01	意のままに行動することができる
PWN:freeman.n.01	農奴や奴隷でない人
PWN:freeze.v.01	動くのを止める、または静止する
PWN:freeze.v.02	氷への変化
PWN:freeze.v.02	氷への変化
PWN:freeze.v.02	氷への変化
PWN:french.n.01	フランスとフランスが植民地にした国々で話されるロマンス語
PWN:frenchman.n.01	フランスの国籍の人
PWN:frequency.n.01	所定の時間内に発生する回数
PWN:frequently.r.01	短い間隔で、何回も
PWN:fresh.a.01	最近作られた、生産された、または収穫された
PWN:fresh.s.08	エネルギーが回復した
PWN:friday.n.01	1週間の第6の日
PWN:friend.n.01	よく知っていて好意を感じ信頼できる人
PWN:fringe.n.06	短めの吊り下げ糸、あるいは房からなる、装飾用の縁取り
PWN:frog.n.01	跳躍するための長い後肢のある種々の尾のないぽっちゃりした体を持つ両生類の総称
PWN:front_tooth.n.01	口の前方に位置する歯
PWN:front.n.01	前方あるいは目立つ面
PWN:frost.n.01	（特に物の外側に）白い堆積物を生じる氷の結晶
PWN:frost.n.01	（特に物の外側に）白い堆積物を生じる氷の結晶
PWN:fruit.n.01	種子植物の成熟した生殖体
PWN:fry.v.02	料理用の油を使い、高温面で調理する
PWN:fry.v.02	料理用の油を使い、高温面で調理する
PWN:fuel.n.01	エネルギーを生み出すために消費される物質
PWN:full.a.01	同じくらい多くの物を含むということは可能または普通のことである
PWN:full.s.04	食糧か飲み物で満足に満たされる
PWN:fume.v.02	微粒子の雲を発する
PWN:function.n.03	個人あるいはグループに割り当てられたり、必要とされたり、期待されたりする行動や活動
PWN:fundamental_law.n.01	政府の基礎的政治上の原理を決定する法律
PWN:funeral.n.01	死者が埋められたり火葬にされる儀式
PWN:fur.n.03	哺乳動物の裁断加工された毛で作られた衣服
PWN:furniture.n.01	部屋または他のエリアを居住できるようにする道具
PWN:furrow.n.01	地面の長く浅いうね（特にすきでできたもの）
PWN:future.a.01	まだである、あるいは到来する
PWN:future.n.01	まだ到来していない時間
PWN:gadolinium.n.01	希土酸化物グループの延性銀白色の延性強磁性の三価染色体の金属元素
PWN:gain.v.08	商業またはビジネス取引で稼ぐ
PWN:gallium.n.01	希少な銀白色（通常は三価）の金属元素
PWN:game.n.01	勝者を決めるための、ルールのある競技
PWN:game.n.02	スポーツまたは他のコンテストの1人でのプレー
PWN:game.n.04	食料または狩猟の獲物として狩りをされた動物
PWN:garbage.n.01	（台所などから）捨てられる食べ物
PWN:garden.n.01	植物を耕す小区画地
PWN:garden.n.03	家に隣接する庭または芝生
PWN:garlic.n.01	広く帰化している南ヨーロッパの球根草本
PWN:garment.n.01	1点の衣類
PWN:gas.n.01	固体や気体と区別される物質の状態：相対的に低密度、低粘性である
PWN:gate.n.01	フェンスや壁についている移動可能の障害
PWN:gate.n.01	フェンスや壁についている移動可能の障害
PWN:gateway.n.01	門で閉じることのできる入口
PWN:gather.v.01	集まるか、集合する
PWN:gay.s.02	元気の良い楽しさに満ちている、または、元気の良い楽しさを見せている
PWN:gear.n.01	伝えられた動きの速度または方向を変えるために、歯のついた別の装置に連結する歯車
PWN:gelatin.n.02	ゼラチンで作った食用ゼリー（甘いのも辛いのもある）でデザートやサラダベースや料理の衣に使われる
PWN:gender.n.01	屈折言語の文法範疇で、名詞、代名詞、形容詞の間の一致を要求するもの
PWN:gene.n.01	ポリペプチド鎖を作り出すのに関係するDNA断片
PWN:generous.a.01	惜しみなく与えて、共有することを望んでいる
PWN:gentle.s.01	柔らかくて、温和である
PWN:gentle.s.01	柔らかくて、温和である
PWN:german.n.01	ドイツの国籍の人
PWN:germanium.n.01	砕けやすい灰色の結晶性の元素で、トランジスターに用いられる（シリコンに似た）半導性メタロイド
PWN:gesticulate.v.01	運動を通じて示す、表す、あるいは指示する
PWN:get_down.v.07	行動を行うことで、第一歩、一歩以上を踏み出す
PWN:get_the_better_of.v.01	勝利を収める
PWN:get_up.v.02	起きて寝床から出る
PWN:get.v.01	具体的、あるいは抽象的な何かの物になる
PWN:get.v.11	追跡した後に捕獲または捕まえることに成功する
PWN:ghost.n.03	死者の肉体から離れ、目に見える魂
PWN:giant_panda.n.01	中国とチベットの竹林に生息する、大きな白黒の草食性哺乳類
PWN:gibbon.n.01	英国の歴史家で、ローマ帝国史でよく知られる（1737年−1794年）
PWN:gift.n.01	保証なしで得られる何か
PWN:gill.n.04	水中に溶解した酸素を吸う水生動物の呼吸器官
PWN:ginger.n.01	太く分岐する香りのよい根茎と葉の多いアシのような茎を持つ、多年生植物
PWN:gingiva.n.01	歯の底部を囲む顎の（粘膜に覆われた）組織
PWN:ginseng.n.01	チョウセンニンジンの香りの高い根
PWN:girl.n.01	若い女性
PWN:give.v.01	抽象的感覚または肉体的感覚で持たせる
PWN:give.v.03	具体的な何かの移動所有または誰かへの要約
PWN:give.v.08	プレゼントとして与える
PWN:glass.n.01	不規則な原子構造をもった砕けやすい透明な固体
PWN:glove.n.02	手に付けるもの：手と手首を覆う
PWN:glowworm.n.01	発光する幼虫、または翅の無い地虫のようなホタルの雌
PWN:glue.n.01	接着剤として使用される、粘着質の物質でできたセメント
PWN:glue.v.01	接着剤、または接着剤のようなものでつなぐ、または取り付ける
PWN:gluey.s.01	接着剤の粘質の特性を持っている
PWN:glutton.n.01	大量に飲み食いすることに身を捧げる人
PWN:go_home.v.01	帰宅する
PWN:go_out.v.04	消えられるようになる
PWN:goalkeeper.n.01	ゴールを守るよう割り当てられたサッカーまたはホッケープレーヤー
PWN:goat.n.01	羊の近縁だが鬚とまっすぐな角を有する非常に多くの敏捷な各種の反芻動物
PWN:god.n.01	完全で、全能で、全知であり、宇宙の創始者であり支配者として考えられている超自然
PWN:goiter.n.01	異常に肥大した甲状腺
PWN:gold.n.03	軟質の黄色い可鍛性の延性がある（三価染色体と一価染色体）金属元素
PWN:golf.n.01	9または18ホールの広い屋外のコースで行われるゲーム
PWN:good_fortune.n.01	好ましい結果から生まれるめでたい状態
PWN:good.a.01	特に指定したものに適している、望ましい、あるいはプラス方向の品質であるさま
PWN:goose.n.01	通常は、カモよりも大きいが、カモほど水生でない水掻きのある肢と長い首を持つ典型的に群生して移動する水鳥
PWN:gourd.n.01	ひょうたんの乾燥した皮で作った瓶
PWN:gourd.n.02	固い皮のある多数の食べられない果実のどれか
PWN:gourd.n.03	堅い皮の果実を実らせるウリ科のつる植物の総称
PWN:govern.v.03	権限を振るう
PWN:government.n.01	政治体の行政部門である組織
PWN:gradual.a.01	小さな場面で進む
PWN:grain.n.08	穀物草
PWN:grammar.n.01	言語学の部門で、構文論や形態論をテーマにする（時には、意味論もテーマにする）
PWN:grandchild.n.01	息子または娘の子供
PWN:granddaughter.n.01	女性の孫
PWN:grandfather.n.01	父あるいは母の父親
PWN:grandma.n.01	父あるいは母の母親
PWN:grandparent.n.01	父あるいは母の親
PWN:grandson.n.01	男の孫
PWN:grape.n.01	緑または紫の表皮を持つブドウ属の様々な果汁のある果物のどれか
PWN:grasp.v.01	しっかりと持つ
PWN:grass_skirt.n.01	長い草の葉で作ったスカート
PWN:grass.n.01	幅の小さい葉を持つ緑の草：芝生として育てられる
PWN:grasshopper.n.01	跳躍するのに適した後肢を持つ、地上性の植物を食べる昆虫
PWN:grasshopper.n.01	跳躍するのに適した後肢を持つ、地上性の植物を食べる昆虫
PWN:grassland.n.01	草、または草のような植物が育ち、植物の優性型である土地
PWN:grateful.a.01	誠意を感じ、示す
PWN:grave.n.02	死体の埋葬の場所（特に墓碑によって記される地面の真下）
PWN:gravity.n.01	宇宙のすべての塊の間の引力
PWN:greece.n.01	ヨーロッパ南東部の共和国で、バルカン半島の南にある
PWN:green.a.03	完全には発達していない、成熟していない
PWN:green.s.01	色のスペクトルにおける、青色と黄色の間の色の
PWN:greet.v.01	人に会うときに挨拶を表現する
PWN:grey.s.01	白と黒の両極端の間で中間のあらゆる明度の無彩色の
PWN:griddle.n.01	食物が料理される平坦な加熱面（ストーブの上でのように）から成る調理器具
PWN:grief.n.02	大きな不幸を引き起こすもの
PWN:grind.v.05	叩くか研磨して、小片か粒にまで小さくする
PWN:groan.v.01	苦痛、不快、または不満を示す
PWN:grocery_store.n.01	食料雑貨が販売される市場
PWN:grok.v.01	意味をとらえる
PWN:groove.n.01	自然の過程（腐食のような）、あるいは工具によって掘られた（例えば、レコードの溝など）長く狭いくぼみ
PWN:group.n.01	1単位として考えられるいくつかの実体（メンバー）
PWN:grow.v.03	自然なプロセスによるサイズの増加
PWN:grow.v.07	育成して栽培する、しばしは農業技術の方法の改良を含む
PWN:gruff.s.02	叫び声または病気または感情からくる音であるかのように、深くて厳しい
PWN:guard.n.01	物や人を見張る人
PWN:guard.v.01	を見張る
PWN:guava.n.03	黄色い皮とピンクの果肉をもつ熱帯性果物
PWN:guest.n.01	もてなしを受ける訪問者
PWN:guestroom.n.01	客が使えるようにしてある寝室
PWN:guilty.a.01	不届きな行為に責任があり、訴えられる
PWN:guilty.a.01	不届きな行為に責任があり、訴えられる
PWN:guitar.n.01	通例6本の弦を持つ弦楽器
PWN:guitar.n.01	通例6本の弦を持つ弦楽器
PWN:gull.n.02	大部分は白い水鳥で、長く尖った翼と短い脚を持つ、
PWN:gun.n.01	高速で弾丸を発射する武器（特に金属管または砲身から）
PWN:gymnastics.n.01	力とバランスと機敏さを披露することを意図する運動を行うスポーツ
PWN:habit.n.01	確立した慣習
PWN:habituate.v.02	心理的に、または身体的に用いる（何かに）
PWN:hafnium.n.01	化学的にジルコニウムに類似し、ジルコニウム鉱物中で見つかる灰色の四価の金属元素
PWN:hail.n.01	強い上昇気流が起こったときにできる氷の粒の降水
PWN:hair.n.01	糸状構造物（人間の頭の上で）の高密度増殖からなる体（またはその部分）の覆い
PWN:half.s.01	値や量を、二つに等しく分けたうちの一つから成るさま
PWN:hammer.n.02	重く頑丈な頭と柄のついた手道具
PWN:hammock.n.02	キャンバスあるいはロープ製の網の吊しベッド（通例2本の木の間に下げる）
PWN:hamster.n.01	旧世界産の大きなほお袋を持つ短い尾の穴居性の齧歯動物
PWN:hand.n.01	（物をつかむのに適している）上肢の先端
PWN:handle.n.01	それを使うかまたは動かすために保持されるようにデザインされている物への付属物
PWN:hang.v.01	つるす、またはぶら下げる
PWN:hang.v.02	つり下げる、またはぶら下げる
PWN:hanukkah.n.01	エルサレムの寺院の再び奉献されたことを記念する8日間のユダヤの祝日
PWN:happen.v.01	起こる
PWN:happiness.n.01	満足な状態から激しい喜びに至る情緒で特徴づけられる健康状態
PWN:happy.a.01	嬉しさや喜びを楽しむこと、見せること、あるいは特徴とするさま
PWN:hard.a.03	重さまたは圧力に抵抗する
PWN:hardly.r.02	ほとんどない
PWN:hardworking.s.01	激務と忍耐によって特徴づけられる
PWN:hare.n.01	分割した上唇と長い後脚を持つアナウサギよりも敏捷で臆病な長い耳を持つ哺乳動物
PWN:hark_back.v.01	何か初期の物に戻る
PWN:harmony.n.01	意見や行動での適合性
PWN:harmony.n.03	一般的なものとそれらの特性（色と音のように）の調和した状態
PWN:harness.n.01	何かを身体に固定するためのひもの配置からなる補助（特にパラシュートから下がる人を支えている1つ）
PWN:harpoon.n.01	投げるための、シャフトととげの突起の付いた槍
PWN:harvest.n.04	作物の収獲をする季節
PWN:hassium.n.01	放射性の超ウラン元素
PWN:hat.n.01	頭を悪天候から保護する頭飾り
PWN:hate.v.01	激しく嫌う
PWN:have.v.01	具体的または抽象的な感覚のどちらかを持つあるいは保有する
PWN:have.v.01	具体的または抽象的な感覚のどちらかを持つあるいは保有する
PWN:hawk.n.01	典型的に短くて丸い翼と長い尾を持つ昼行性猛禽
PWN:hawthorn.n.01	サンザシ属の春咲きの低木か小さい高木
PWN:hay.n.01	まぐさ用に刈り取って処理する草
PWN:head_covering.n.01	頭部や顔を覆う衣装
PWN:head_louse.n.01	人の頭や体に群がる
PWN:head.n.01	人体の上部か動物のボディーの前面
PWN:head.n.04	管理する人
PWN:headdress.n.01	頭用の衣装
PWN:headman.n.02	部族や一門の長
PWN:healthy.a.01	体または心の健康を持つか、示すさま
PWN:hear.v.01	聴覚の感覚を経て（音）に気づく
PWN:heart.n.02	肋骨の後ろと肺に間にあるくぼんだ筋肉器官
PWN:hearthstone.n.01	暖炉を形成する石
PWN:heat.n.01	温度差によって移動するエネルギーの形態
PWN:heaven.n.02	神と天使の住まい
PWN:heavy.a.01	比較的大きな物理的な重量あるいは密度の
PWN:heel.n.02	人の足の後ろの部分
PWN:height.n.01	長さの垂直の寸法
PWN:helium.n.01	6個の不活性なガスの一つであるとても軽く無色の要素
PWN:helix.n.01	円柱または円錐の表面にあり、一定の角度で要素を切る曲線
PWN:hell.n.04	死者の世界
PWN:helmet.n.02	頭部を保護する硬質の被り物で打撃に耐える
PWN:help.v.01	助けたり援助する
PWN:hen.n.01	大人の雌のニワトリ
PWN:herb.n.01	永久的な木質茎を持たない植物
PWN:herd.n.01	人間が番をする畜牛やヒツジなど、同種の哺乳類の家畜のグループ
PWN:herd.v.01	群がる、追いやるあるいは、大勢集まらせる
PWN:herder.n.02	家畜の群れを追いたてる人
PWN:here.r.01	この場所においてあるいはこの場所で
PWN:here.r.03	この場所に（特に話者に向かって）
PWN:hermit.n.02	一人で暮らす人
PWN:heron.n.02	長い首と長い脚と（たいてい）長いくちばしを持つ灰色または白の渉禽
PWN:hesitate.v.02	継続前に活動を一時的に中断する
PWN:hevea.n.01	ラテックスを産出する南米の高木の小さな属
PWN:hiccup.n.01	可聴音を発生させる声門の急速な閉鎖で横隔膜の反射的な発作を伴わせる状態
PWN:hiccup.v.01	突発的に息をし、音をたてる
PWN:hide.n.02	生きている動物の体を覆うもの
PWN:hide.v.01	見られる、または発見されるのを防ぐ
PWN:hide.v.02	じっとする、あるいはじっとした状態になる
PWN:hieroglyph.n.02	絵の記号を使う書記法
PWN:high_tide.n.01	水が一番高いときの潮
PWN:high.a.01	程度、強度、または量で普通より大きい
PWN:high.r.01	非常に高い高度で
PWN:hill.n.01	土地の部分的な、はっきりした隆起
PWN:hill.n.01	土地の部分的な、はっきりした隆起
PWN:hinduism.n.01	インド、バングラデシュ、スリランカ、およびネパールのほとんどの人々の宗教
PWN:hinge.n.01	一方が他方に対して揺れ動くようにした2つの部分が畳んで1つになるような装置
PWN:hip.n.01	ウエストの下の、また、腿より上の体の一方の側
PWN:hippopotamus.n.01	皮の厚い巨大な草食動物で、熱帯アフリカの川の中や周辺にすむ
PWN:hire.v.01	仕事のために雇用するあるいは、借りる
PWN:history.n.01	過去の出来事の集合体
PWN:history.n.02	過去の出来事の記録または物語風の記述
PWN:hit.v.02	当たる
PWN:hoe.n.01	長い柄に対して、平たい刃が直角に付いた道具
PWN:hog.n.03	家畜豚
PWN:hold.v.02	その人の手または掴むことで持つ、あるいは固定する
PWN:hole.n.01	何かの中へ、あるいは通り抜ける始まり
PWN:hollow.a.01	固体でない
PWN:hollow.v.02	内部を取り除く
PWN:holmium.n.01	希土類の3価の金属元素
PWN:holy.a.01	神通力に属している、から派生した、またはに関連している
PWN:home.n.01	特定の時に住んでいるところ
PWN:honey.n.01	ミツバチの作る甘い黄色い液体
PWN:honor.v.01	名誉や報酬を付与する
PWN:hoof.n.01	有蹄哺乳類の足
PWN:hook.n.05	何かを下げたり引っ張ったりするための曲がった道具
PWN:hope.n.02	ある欲望が貫徹する一般的感情
PWN:hope.v.02	楽観的である
PWN:horizontal.a.01	平行線または基線に対して平行または同じ面に属して
PWN:horizontal.a.01	平行線または基線に対して平行または同じ面に属して
PWN:horn.n.01	（パーティーやゲームなどで）吹くと大きな音が出る装置
PWN:horn.n.02	ある特定の有蹄動物の頭に生えた骨質のものの1つ
PWN:horse_tick.n.01	馬に寄生する翅のあるハエ
PWN:horse.n.01	先史時代から家畜化されている、蹄のある草食性の四肢動物
PWN:horsefly.n.02	雌は様々な動物の血を吸う敏捷な大型のハエ
PWN:hospital.n.01	患者が治療を受ける健康設備
PWN:hospital.n.02	病人や怪我人が治療や手術を受ける医療機関
PWN:host.n.01	（自宅でのパーティーといった）社交行事でお客を招き、滞在中の世話をする人
PWN:host.v.01	主人役となる
PWN:hostage.n.01	相手側が指定した条件を満たすよう確実にするために確保する人質
PWN:hot.a.01	物理的な熱について使用される
PWN:hotel.n.01	旅行者が宿と食事その他のサービスを買える建物
PWN:hour.n.01	時間の周期、1日の1/24と等しい
PWN:house.n.01	1家族以上のための居住棟として機能する住居
PWN:hovel.n.01	住居として使われる小さい粗雑な避難所
PWN:howl.v.01	長い大きい叫び声を発する
PWN:howl.v.02	動物のように大声で泣く
PWN:huge.s.01	通常、サイズ、量、度数、特に程度または範囲において大きな
PWN:humid.s.01	多量の水蒸気を含んでいる、または、によって特徴づけられる
PWN:hummingbird.n.01	輝かしい虹色の羽毛と長く細長いくちばしがある小さいアメリカの鳥
PWN:hundred.s.01	90よりも10多い
PWN:hungarian.n.01	ハンガリーの出身者、または、居住者
PWN:hunger.n.01	食物の生理的な必要性
PWN:hungry.a.01	飢えを感じるさま
PWN:hunt.v.01	食物またはスポーツのために追求する（野生動物のような）
PWN:hurt.v.06	身体的な痛みを感じる
PWN:husband.n.01	結婚した男性
PWN:husband.n.01	結婚した男性
PWN:hydrochoerus.n.01	齧歯目カピバラ科の1属
PWN:hydrogen.n.01	通常、無色の、そして、無臭の非常に可燃性の二原子のガスである非金属の一価要素
PWN:hymn.n.01	（神、聖人あるいは国家を）たたえる歌
PWN:ibis.n.01	長く細い下向きに曲ったくちばしを持つ温帯にすむ渉禽
PWN:ice_hockey.n.01	各6人のスケーターからなる2つのチームが、平たく円いパックをホッケー・スティックで相手側のゴールに叩き込む氷上のゲーム
PWN:ice.n.01	凍って固体となった水
PWN:idea.n.01	認知の内容
PWN:identical.s.01	うり二つである
PWN:idol.n.01	崇拝される有形の像
PWN:idol.n.01	崇拝される有形の像
PWN:igloo.n.01	エスキモーの小屋
PWN:ignite.v.01	燃え始める原因
PWN:igniter.n.01	発火させる、または燃やすのに使用される物質
PWN:ill-mannered.s.01	社会的に誤った行動
PWN:ill.a.01	通常の身体的であるか精神的な機能の減退に影響を受ける
PWN:imagine.v.01	存在しない、あるいは、事実と異なる心像を形成する
PWN:imitate.v.01	人の行動や外観を再現する
PWN:immediately.r.01	遅れ、または躊躇なしで
PWN:immediately.r.01	遅れ、または躊躇なしで
PWN:impatient.a.01	落ちつかない、遅れに対して気が短い、あるいは敵対している
PWN:impede.v.01	障害または障害である
PWN:impermanent.a.01	永久的でない
PWN:important.a.01	大きな意義または価値
PWN:improbable.a.01	真実でなさそうな、起こりそうにない、起こりそうになかった
PWN:inclination.n.01	特にある選択肢を他の選択肢より好むという精神的な意向
PWN:incorporate.v.02	包含するか、含む
PWN:increase.v.01	量がより大きくなる
PWN:incrimination.n.01	ある過失や不正犯罪に責任があることに対しての告発
PWN:independent.a.01	外部の支配と制約がない
PWN:india.n.01	南アジアのアジアの亜大陸の共和国
PWN:indicate.v.02	場所、方向、人、または物事を指す
PWN:indium.n.01	まれな軟質の銀の金属元素
PWN:individual.n.02	一個の生物
PWN:influenza.n.01	非常に感染力の強い急性のウィルス性熱病
PWN:information.n.01	受け取られて、理解されるメッセージ
PWN:injection.n.03	注射器を用いて体の中に液体を入れる行為
PWN:injure.v.01	怪我または身体傷害を引き起こす
PWN:ink.n.01	印刷や筆記、描画に使われる液体
PWN:inner.s.01	内部に位置する
PWN:innocent.a.01	悪または罪とは無縁の
PWN:innocent.a.01	悪または罪とは無縁の
PWN:insect.n.01	小型の空気呼吸を行う節足動物
PWN:insert.v.01	何かに入れるあるいは導入する
PWN:instrument.n.02	それによって何かが達成される手段
PWN:insurance.n.01	損失の場合に償還する契約
PWN:intelligent.a.01	特に高度に思考と理性の能力を持つ
PWN:intend.v.01	目的として考える
PWN:intention.n.03	意図した行為
PWN:intentionally.r.01	意志をもって
PWN:interest.n.01	誰かあるいは何かにかかわり合いたいという関心と好奇心
PWN:interfere.v.01	障害または邪魔になるように間に入る
PWN:international.a.01	すべての国、あるいは少なくとも2カ国以上の国に関係があるか、または属しているさま
PWN:internet.n.01	データの通信や交換を容易にするためにTCP/IPネットワークプロトコルを用いた、世界的に広がったネットワークから成るコンピュータネットワーク
PWN:internet.n.01	データの通信や交換を容易にするためにTCP/IPネットワークプロトコルを用いた、世界的に広がったネットワークから成るコンピュータネットワーク
PWN:internet.n.01	データの通信や交換を容易にするためにTCP/IPネットワークプロトコルを用いた、世界的に広がったネットワークから成るコンピュータネットワーク
PWN:interrupt.v.02	平和または静けさを破壊する
PWN:intestine.n.01	胃と肛門の間の消化管の部分
PWN:intoxicated.a.01	化学物質（特にアルコール）によって無感覚になるか、興奮する
PWN:invent.v.01	思考錯誤の後で思いつく（考え、計画、説明理論または主義）
PWN:inverted.s.01	上下が逆にされるような位置にあるさま
PWN:invest.v.01	投資を行う
PWN:invite.v.01	可能性を増やす
PWN:invite.v.02	家に人を招待する
PWN:invite.v.02	家に人を招待する
PWN:iodine.n.01	ハロゲンに属す非金属元素
PWN:iridium.n.01	プラチナグループの重い脆い金属要素
PWN:iris.n.01	剣の形をした葉と、3つの花弁と3つの垂れ下がった萼片から構成されている明るい色の花を付ける直生の茎のある植物
PWN:iris.n.02	目に入る光量が、順番に制御される瞳孔の大きさを制御する筋骨逞しい横隔膜
PWN:iron.n.01	重く延性に富み、磁性を帯びた金属元素
PWN:irregular.a.01	規則または右傾入れられた命令または一般的な習慣に反して
PWN:islam.n.01	イスラム教の宗教によって支配される一まとめにイスラム教の文明
PWN:island.n.01	水によって囲まれる陸の塊（大陸よりも小さい）
PWN:issue.n.01	論争の重要な論点で、解決しなければならないこと
PWN:issue.n.02	定期的に出版される連続出版物の中の1つ
PWN:itch.n.03	ひっかきたいという欲求を起こさせるいらいらする皮膚感覚
PWN:itch.v.02	かゆみがあるか、知覚する
PWN:item.n.01	リスト上で列挙される物も集団で別々に特定できる独立した部分
PWN:jacket.n.01	短いコート
PWN:jade.n.01	強い光沢を帯びる半貴石の宝石
PWN:jaguar.n.01	ヒョウに似た熱帯アメリカの斑点模様のあるネコ科の大型動物
PWN:january.n.01	1年の最初の月
PWN:jar.n.01	取っ手のない（通例筒状の）広口容器
PWN:jaw.n.01	口を形成し、歯を支える脊椎動物の頭蓋の一部分
PWN:jealousy.n.01	（特に競争相手に対する）嫉妬深いねたみの感情
PWN:jean.n.01	手作業向け、またはカジュアルな服装として着られる重いデニムの体にぴったりあったズボン
PWN:jelly.n.03	ゼリーまたはゼラチンの粘性のある物質
PWN:jersey.n.03	ぴったりしたプルオーバーのシャツ
PWN:jesus.n.01	指導者、予言者で、ベツレヘムで生まれ、ナザレで活動した
PWN:jewel.n.01	宝飾品の一部にはめ込まれた宝石または半貴石
PWN:job.n.02	義務として、あるいは、特定の料金のために行うことを要求される特定の仕事
PWN:join.v.02	接続させられる、あるいは結合させられる
PWN:joint.n.05	ここで部品や物体どおしが接続される
PWN:joke.n.01	笑いを誘おうとするユーモラスな逸話または言葉
PWN:journey.n.01	ある場所から別の場所へ移動する行為
PWN:joy.n.01	非常にうれしく感じること
PWN:judaism.n.01	旧約聖書とタルムードに基づく宗教を実践するユダヤ人
PWN:judge.n.01	裁判所の前にもたらされた問題を決定する権限を与えられた公務員
PWN:judge.v.01	（競争）の結果を決定する
PWN:judgment.n.03	法定に提出された事柄について司法権の法廷による決定
PWN:juice.n.01	しぼれるか、料理することによって設備または動物性組織から引き抜かれることができる液体の一部
PWN:july.n.01	6月の後、8月の前の月
PWN:jump.v.01	飛躍的に前進する
PWN:june.n.01	5月の後、7月の前の月
PWN:jury.n.01	法廷に提出された証拠により真実の評決を行うと宣誓した市民たちの集団
PWN:kangaroo.n.01	大きくて強力な後脚と長くて太い尾を持つオーストラリア・ニューギニア産の草食性で跳躍性の有袋動物類各種
PWN:keep.v.01	特定の状態、位置または活動を維持する
PWN:keep.v.03	保有を続ける
PWN:keep.v.03	保有を続ける
PWN:keep.v.19	生活必需品として持っている
PWN:kelp.n.01	溝つきの皮のような葉状体を持つ大きな褐色の海草
PWN:kettle.n.01	煮込んだり沸騰させるための金属の鍋
PWN:key.n.01	錠に差し込んだとき錠前のメカニズムが回転するように型取られた金属器具
PWN:kick.v.01	足で運転するか進める
PWN:kick.v.03	足で打つ
PWN:kid.n.05	若いヤギ
PWN:kidnap.v.01	彼らの意志に反して、通常、身代金を引き出すために、明らかにされていない場所に奪い去る
PWN:kidney.n.01	血液から排泄物を濾過し（特に尿素）、それらを排泄し水分の中に分泌液を出す2つの豆形の排泄器官のどちらか
PWN:kill.v.01	死なせる
PWN:kill.v.10	無意識に、死を引き起こす
PWN:kilogram.n.01	1,000グラム
PWN:kin.n.02	血縁や婚姻によって結ばれた人々のグループ
PWN:kind.n.01	共通の特徴や質で区別されるものの範疇
PWN:king.n.01	男性の君主
PWN:king.n.01	男性の君主
PWN:king.n.10	最も弱いがもっとも重要な駒
PWN:kingfisher.n.01	短い尾に長く鋭いくちばしを持ち、非スズメ類の大きな頭部を持つ鳥
PWN:kitchen.n.01	食事を用意するための部屋
PWN:kite.n.03	ティッシュペーパーでおおわれている軽い骨組みからなるおもちゃ
PWN:knead.v.01	均一にする
PWN:knee.n.01	脛骨と腓骨を大腿骨に結びつけ、膝蓋によって前部を保護されている人間の脚にある蝶番関節
PWN:kneel.v.01	その人の重体重をその人のひざにのせて休む
PWN:knife.n.01	切断器として使用される刃物
PWN:knife.v.01	ナイフを使用する
PWN:knight.n.01	本来は武技や騎士道の訓練を受けた高貴な生まれの人
PWN:knight.n.02	馬の頭に類似するように形成されたチェス駒
PWN:knit.v.01	編んで（織物）を作る
PWN:knob.n.01	円形の丸い突起
PWN:knob.n.02	丸い取っ手
PWN:knock.v.02	拳骨でたたく
PWN:knock.v.06	非難する
PWN:knot.n.02	ロープ（またはひも）を輪にして、自身か別のロープ、または物体に結びつけて作る様々な締め具
PWN:know.v.01	事実または特別の情報を認識するまたは気づく
PWN:know.v.02	何かをするか、実行する方法を知っている
PWN:know.v.04	ある人や物に馴染み深く、知っている
PWN:kohlrabi.n.02	カブラの形をしたコールラビの多肉質の茎
PWN:krypton.n.01	6つの不活性気体の1つである無色の元素
PWN:label.n.01	区別するための短い描写
PWN:ladder.n.01	横桟で繋がった2本の部材
PWN:lagoon.n.01	砂または珊瑚の礁によってより本流から分断される水域
PWN:lair.n.01	野生の動物が住む所
PWN:lake.n.01	陸地に囲まれた（通常塩分を含まない）水域
PWN:lamb.n.01	子羊
PWN:lamp.n.01	可視照明の人工的源
PWN:land.n.02	（特にその使用価値との関連において）植物が育つところ
PWN:land.n.04	地表の固体の部分
PWN:land.n.04	地表の固体の部分
PWN:land.n.04	地表の固体の部分
PWN:land.v.06	上陸して到着する
PWN:language.n.01	音または慣習的記号を用いたコミュニケーションの体系的な手段
PWN:lanthanum.n.01	容易に曇る白い軟質の金属元素
PWN:lap.n.01	着席した人の腿の上部
PWN:larch.n.02	すべて脱落性の針状の葉を持っているカラマツ属の多数の針葉樹のいずれか
PWN:large.a.01	サイズ、数、量、大きさまたは範囲において平均以上の
PWN:large.a.01	サイズ、数、量、大きさまたは範囲において平均以上の
PWN:lasso.n.02	動物の捕獲に使用する、長い輪縄
PWN:last.a.02	時間内にのすべての他のもの、スペースまたは度に続いているか、唯一無二の残りです
PWN:last.v.01	特定の期間やり通す
PWN:late.r.01	通常または予測されるより遅く
PWN:laugh.n.01	笑っている音
PWN:laugh.v.01	笑いを引き起こす
PWN:laughter.n.02	笑う行為
PWN:law.n.01	行政当局によって課された規則の集まり
PWN:lawrencium.n.01	カリフォルニウムから合成される、放射性の超ウラン元素
PWN:lawyer.n.01	弁護士の権限を与えられた専門家
PWN:lay.v.02	水平の位置に置く
PWN:layer.n.01	単一の厚さのある種の通例同質の物質
PWN:lead.n.02	軟質の重い毒性あるの可鍛性の金属元素
PWN:lead.v.01	誰かをどこかに連れて行く
PWN:lead.v.01	誰かをどこかに連れて行く
PWN:leader.n.01	人を支配したり、指導したり、人に影響を与えたりする人
PWN:leaf.n.01	高等植物の、光合成と蒸散の為の主要器官
PWN:learn.v.01	知識または能力を獲得する
PWN:leash.n.01	動物を拘束するのに用いるロープ（または軽い鎖）からなる拘束道具
PWN:least.a.01	質量名詞と共に使用でき、通常、『the』によって先行されている『little』の最上級
PWN:least.r.01	最上を作るのに用いられる
PWN:leather.n.01	毛を取り除き、なめして、滑らかで柔らかくした動物の皮
PWN:lecture.v.01	講義をするまたは話す
PWN:left.r.01	左の方へ、または、の上の
PWN:leg.n.02	人間の脚に似ており、移動に使われる動物の構造
PWN:lend.v.02	一時的に与える
PWN:lend.v.02	一時的に与える
PWN:length.n.01	空間の一方の端から他の端までの線的な範囲
PWN:lens.n.01	透明な光学装置で、伝導された光を集中または分岐させ像を作るのに用いられる
PWN:lent.n.01	聖灰水曜日から聖土曜日までの40日間
PWN:lentil.n.01	食用のレンズ豆植物の丸い平坦な種子
PWN:leprosy.n.01	熱帯、亜熱帯地方の、伝染性の慢性肉芽腫
PWN:less.a.01	量や程度においてそれほど大きくない量の意味
PWN:less.r.01	いくつかの形容詞と副詞の比較級を作るのに用いられる
PWN:let_go_of.v.01	掴んでいるものなどを、解放する
PWN:let.v.01	何かを起こすことを行動の特定の動きまたは、動かないことより可能にする
PWN:letter.n.01	人または組織に宛てた書かれたメッセージ
PWN:lettuce.n.02	アキノノゲシ属の各種の植物の総称
PWN:lever.n.01	支点にし回転する硬直した棒
PWN:liana.n.01	通常は熱帯植物の、巻きついてのぼる性質の木本
PWN:liberate.v.03	自由を与える
PWN:library.n.01	図書が保管されている場所
PWN:library.n.05	図書のコレクションその他の資料を収めた建物
PWN:license_plate.n.01	車の正面や後ろに取り付けられ、自動車の登録番号がついているプレート
PWN:license.n.01	何かをする公式の許可を与える法律文書
PWN:lick.v.02	舌を擦り付ける
PWN:lid.n.02	箱、瓶、鍋などの容器の口を閉じるための（蝶番で留まっていたり別になっていたりする）動かせるカバー
PWN:lie_down.v.01	横たわっている体勢であると考えられる
PWN:lie.n.01	真実からそれるまたは真実を誤らせる言明
PWN:lie.v.01	どこかにある、あるいは位置する
PWN:lie.v.02	横たわる、ひれ伏す
PWN:lie.v.05	うそを言う
PWN:life.n.02	生きていることの経験
PWN:lift.v.03	上昇する
PWN:light.a.01	比較的少ない物理的な重さか密度について
PWN:light.a.06	光によって特徴づけられる、または、を発する
PWN:light.n.01	視覚の感覚を生じさせる電磁放射
PWN:lightning.n.01	発光によって伴われる、突然の雲から雲へまたは雲から地上への放電
PWN:like.v.02	楽しい、または好みだと感じる
PWN:like.v.03	の好きな
PWN:lima_bean.n.02	低木あるいは高木のマメ植物で、種子は大きくて平たく、食用に適する
PWN:limit.n.01	何かの可能な最大の程度
PWN:limp.v.01	多少の身体的制約または負傷により歩行が妨げられる
PWN:line.n.01	人または物を隣同士にする構成
PWN:line.n.04	幅または厚みのない長さ（まっすぐであるか曲がった）
PWN:line.n.04	幅または厚みのない長さ（まっすぐであるか曲がった）
PWN:linen.n.01	アマから採った繊維で織った織物
PWN:lion.n.01	雄には毛深い鬣のある黄褐色の毛並みを有するアフリカとインドの大きな群生している捕食性の猫科の動物
PWN:lip.n.01	口を囲んで、話す役割を果たす組織の肥満した2つのひだのどちらか
PWN:liquid.n.01	室温と室圧で液体である物質
PWN:liquor.n.01	発酵ではなく蒸留して作ったアルコール飲料
PWN:list.n.01	規則正しく配列した項目（名前または案件）を含むデータベース
PWN:listen.v.01	注意して聞く
PWN:listen.v.02	聞いて、注意を向ける
PWN:liter.n.01	容量のメートル単位、以前は標準状態下の1キログラムの純水量と定義された
PWN:lithium.n.01	柔らかくて銀灰色の1価のアルカリ金属元素
PWN:little_brother.n.01	弟
PWN:little_sister.n.01	妹
PWN:little.a.02	量または程度が小さい
PWN:little.r.01	それほど多くないさま
PWN:little.r.01	それほど多くないさま
PWN:liver.n.01	腹腔の右上部にある大きくて複雑な赤茶色の腺器官
PWN:livestock.n.01	使用したり利益を生む各種の動物
PWN:living_room.n.01	個人の家や施設で人が座って話したりリラックスしたりできる部屋
PWN:living_thing.n.01	生きている（または一度は生きていたば）実在物
PWN:lizard.n.01	通常二対の肢と先細の尾を持つ、比較的に長い体をした爬虫類
PWN:load.n.01	担ったり運んだりされるもの
PWN:lobster.n.02	ウミザリガニ科・アカザ科・イセエビ科の食用海産甲殻類の動物各種
PWN:lock.n.01	ドアや引き出しにぴったりついて、しっかりと閉めたままにしておく留め具
PWN:loft.n.02	屋根のすぐ下の家の上部の仕切のないスペース
PWN:logic.n.01	推論を分析する哲学の分野
PWN:lonely.s.02	一人であることからの落胆により特徴づけられる
PWN:long_ago.r.01	遠いか比較的遠い過去の
PWN:long.a.01	主に現世の感覚
PWN:long.a.02	主として空間的な感覚
PWN:long.r.01	延長時間のために、または現実的でない時間において
PWN:long.r.02	延長した距離のために
PWN:longing.n.01	長引いている果たされていない願望か必要性
PWN:look_forward.v.01	期待する、または望む
PWN:look.v.01	注意して知覚する
PWN:look.v.02	ある印象を与える、またはある外観を持つ
PWN:loom.n.01	糸を織って織物を作るための織物機械
PWN:loop.n.02	円形または楕円形のもの（曲線で形成され、閉じていてそれ自身と交差しない）
PWN:loose.a.01	構造または配置において小型または濃密でない
PWN:loose.a.03	きつくない
PWN:loose.s.08	緊張していない、または張り詰めていないさま
PWN:loosen.v.01	ゆるくするまたはより緩くする
PWN:loot.n.01	不法に得られた品物あるいは金銭
PWN:lord.n.03	王国の称号を持つ貴族
PWN:lose.v.01	保つこと、または維持することができない
PWN:lose.v.02	勝つことに失敗する
PWN:lose.v.05	その人の所有物からなくなる
PWN:loss.n.01	紛失したもの
PWN:loss.n.04	何かを失うことによって生ずる不利益
PWN:loss.n.06	商業活動のコストが歳入を超えている額
PWN:loud.a.01	大音量、または激しい音により特徴づけられる、またはそれを生じる
PWN:loudly.r.01	比較的高いボリュームで
PWN:louse.n.01	温血動物に寄生する羽の無いたいてい平らな体の吸血虫
PWN:love.v.03	に夢中である、心を奪われる
PWN:lovely.s.01	目と同様に心にうったえる
PWN:lover.n.01	だれかを愛している、またはだれかに愛されている人
PWN:low_tide.n.01	潮の最も低い（最も遠い）干潮
PWN:low.a.01	程度、強さまたは量で通常以下である
PWN:low.r.01	低い位置で
PWN:loyal.a.01	忠誠または任務において不動である
PWN:luminosity.n.01	光を発する性質
PWN:lunch.n.01	昼食
PWN:lung.n.01	脊椎動物の胸郭にある2つの嚢状の呼吸器官
PWN:lupine.n.01	ハウチワマメ属の植物の総称
PWN:lutetium.n.01	希土酸化物グループの三価染色体の金属元素
PWN:machine.n.01	エネルギーを伝送あるいは変形して、人間の仕事をさせたり助けさせたりする機械的あるいは電気的装置一般
PWN:madagascar.n.01	マダガスカルの島の共和国
PWN:maestro.n.01	究極の芸術家
PWN:magazine.n.01	購入、または定期購読する人にとって興味深い写真、小説、および記事を掲載する定期刊行物
PWN:magic.n.01	人知を超えた力を呼び出す技
PWN:magnesium.n.01	軽くて銀灰色の延性に富んだ二価の金属元素
PWN:magnet.n.01	鉄を引きつけ磁場を作る装置
PWN:magpie.n.01	ぺちゃくちゃ鳴く鳴声を発する長い尾を持つ黒と白の鳥
PWN:mail.n.02	メッセージが郵便局を通して送られるシステム
PWN:mail.v.01	郵便で送る
PWN:mailman.n.01	手紙を配達する人
PWN:mainland.n.01	国または大陸の大部分を占める中心的な陸地
PWN:majority.n.01	2より大きい部分によって生じる、あるいは、に関連した特性
PWN:make_noise.v.01	騒音を出す
PWN:make.v.01	従事する
PWN:make.v.03	になる、あるいは、にさせる
PWN:make.v.49	小便をする
PWN:male_child.n.01	若い男
PWN:male.a.01	産出において受精機能を実行する配偶子（精子）を生産する性別であること（植物または動物の）
PWN:male.s.03	男または少年で成る、またはそれらに関する、またはそれらのための
PWN:malus.n.01	リンゴの木
PWN:mammal.n.01	皮膚がほぼ毛で覆われている、温血脊椎動物
PWN:man.n.01	（成人女性に対するものとして）男性である大人
PWN:manage.v.02	その任にある、それとして動く、あるいは処理する
PWN:mandarin.n.01	甘くて香りのよい果肉と黄色がかったオレンジ色から赤みがかったオレンジ色の薄い外皮を持つ、平たい球状の果実の低木または小高木で、皮は緩く、むきやすい
PWN:manganese.n.01	鉄に似ているが磁石でない堅くもろい灰色で多価の金属元素
PWN:manger.n.01	牛や馬などがえさを食べる（通例家畜小屋や納屋の）容器
PWN:mango.n.01	卵形の大きな果実のために栽培されている、大型の熱帯常緑高木
PWN:mango.n.02	香りのよい多汁質の果肉と毛状大きな種をもつ、大型で卵形のなめらかな皮の熱帯性果物
PWN:mangrove.n.01	熱帯の木、または低木で、木の上にフルーツの実をつけ、建物を建設する際に重要な、計り知れない数の支柱根を形成する
PWN:manner.n.01	何かがされる方法またはそれが起こる方法
PWN:mantis.n.01	温帯地域に生息する捕食性の長い体の大きな眼を持つ昆虫
PWN:manufacture.v.01	人工または自然の構成要素あるいは部品から組立てられる
PWN:many.a.01	可算名詞と共に使用できて、しばしば『as』『too』によって先行されている数量詞、『so』または『that』
PWN:map.n.01	地球の表面（あるいはその一部）の図式的な表示
PWN:maple.n.01	様々なカエデの高木の材
PWN:maple.n.02	一対の羽のある種をつけるエイサー属の多数の木または低木の総称
PWN:march.n.01	2月に続く、4月の前の月
PWN:mare.n.01	ウマ科の雌の動物
PWN:marijuana.n.01	その乾いた葉から多くの強壮薬多幸化薬と幻覚を誘発する薬が調合される匂いの強い植物
PWN:mark.n.01	質を指し示す数あるいは文字（特に学生の成績）
PWN:marketplace.n.02	公けの商業施設が建てられている町の地域
PWN:marmot.n.01	北半球を通じて見られる短い毛の多いしっぽをもったずんぐりむっくりの粗い毛の穿孔齧歯動物
PWN:marriage.n.01	自発的に人生（または離婚まで）のために結ばれた夫婦である状態
PWN:marriage.n.03	結婚する行為
PWN:marry.v.01	嫁にもらう
PWN:mason.n.04	石やれんがを扱う職人
PWN:massage.v.01	通常治療、緩和を目的として、手で（だれかの身体）を巧みに扱う
PWN:mast.n.01	帆を支えるための垂直な円材
PWN:master_of_science.n.01	科学の修士
PWN:master.n.08	大学の修士の学位を持っている人
PWN:mastermind.v.01	（複雑な仕事）を計画して、指示する
PWN:mat.n.01	床おおいとして使われる厚く平らなパッド
PWN:match.n.01	1片の薄い木切れあるいは燃焼性の化学薬品が先端に付けられたボール紙から成るライター
PWN:match.n.09	似ていて調和するもの
PWN:mate.n.06	対の片方
PWN:mate.n.09	マテと呼ばれる南米のヒイラギの葉で作った、茶のような南米の飲み物
PWN:matter.n.01	漠然としたある関心
PWN:matter.n.03	体積を持ち空間を占めるもの
PWN:mattress.n.01	弾力のある詰め物がしてあり、しばしばコイルばねを内蔵する大きく厚いマットで、ベッドとして、あるいはその一部として使われる
PWN:may.n.01	4月の後、6月の前の月
PWN:mayor.n.01	市行政の長
PWN:mead.n.03	発酵したハチミツと水で作られる
PWN:meal.n.01	1回に出されて、食べる食事
PWN:meal.n.01	1回に出されて、食べる食事
PWN:meandering.s.01	例えば経路の
PWN:meaning.n.01	意図されたまたは表現されたメッセージ
PWN:measure.n.02	定量化できるものがいくらあるか、またはいくつあるか
PWN:measure.v.01	何かまたは誰かの測定値を測定する、を測定する
PWN:meat.n.01	食料として使われる動物（魚と鳥とカタツムリを含む）の肉
PWN:medicine.n.01	非外科的技術を扱う医学の部門
PWN:medicine.n.02	病気の症状を治療する、予防する、または緩和する物
PWN:medicine.n.02	病気の症状を治療する、予防する、または緩和する物
PWN:meet.v.07	1つの場所に集まる
PWN:meet.v.09	デザインで見合う
PWN:meitnerium.n.01	放射性超ウラン元素
PWN:melt.v.01	通常熱することにより固体から液体の状態へ減少する、あるいは減少される原因となる
PWN:member.n.01	ある社会のグループを構成している人の1人（特に団体に加わり参加している個人）
PWN:memory.n.01	覚えていること
PWN:memory.n.03	過去の経験を保持し思い出すことができる力
PWN:men's_room.n.01	男性用公衆トイレ
PWN:mendelevium.n.01	アインスタイニウムをアルファ粒子に衝突させて合成する放射性超ウラン元素（Mdがメンデレビウムの現在の記号であるが、以前はMvだった）
PWN:merchant.n.01	小売り業に従事している実業家
PWN:mercury.n.01	重い銀色の有毒の1価と2価の金属元素
PWN:merely.r.01	そして、多くは何もない
PWN:message.n.01	書いたり、話したり、合図したりして伝えられる（普通短い）伝達
PWN:metabolism.n.02	生物の成長過程（細胞や生物で）で生命に必要なもの
PWN:metallic_element.n.01	通例光沢のある固体で、熱または電気を伝導し、シートなどに加工できる様々な化学元素の総称
PWN:metamorphosis.n.01	何匹かの動物に起こる成体への幼虫のきわだって急速な変化
PWN:meter.n.01	長さの基本単位で国際単位系で採用されている（約1.094ヤード）
PWN:method.n.01	何かを行う方法、特に体系的なもの
PWN:microbe.n.01	微小生命体（特に病気をもたらすバクテリア）
PWN:microscope.n.01	小さな物体の像を拡大する装置
PWN:midnight.n.01	夜の12時
PWN:military.a.01	戦争の原則の研究の、または、戦争の原則の研究に関する
PWN:milk.n.01	哺乳動物が分泌する白い滋養分に富む液体で人間の食物に使う
PWN:milk.v.01	雌の哺乳動物から乳を搾る
PWN:milky_way.n.01	太陽系を含む銀河
PWN:mill.n.04	材料を挽く、または押しつぶして加工する機械
PWN:mill.n.04	材料を挽く、または押しつぶして加工する機械
PWN:million.s.01	1,000,000の項目または単位からなる量を意味する
PWN:mince.v.03	細かく切った
PWN:mind.n.01	その人の考えと感情に関与している
PWN:mind.n.01	その人の考えと感情に関与している
PWN:mineral.n.01	個々の化学組成を持つ、自然界において見出される固体で均質な無機物
PWN:minister.n.02	政府の高い地位に任命される人
PWN:minority.n.01	自分達もその一部である、より大きな集団の、人種的または政治的に異なる人達の集まり
PWN:minority.n.02	2つの部分のうち数の少ない方であること、またはそれに関連していること
PWN:mint.n.02	北部温帯のハッカ属の植物で、香りの良い葉と藤色の小さな花を持つ
PWN:minute.n.01	60秒または1/60時間と等しい時間の単位
PWN:miracle.n.01	驚くべきすばらしい出来事
PWN:mirror.n.01	反射光によって像を形づくる磨いた面
PWN:misfortune.n.02	好ましくない結果から生じる不幸な状態
PWN:misplace.v.01	人が二度とそれを見つけることができない場所に（何か）を置く
PWN:miss.n.03	未婚の女性のための敬称
PWN:miss.v.01	感覚または認識で知覚または捉えることができない
PWN:miss.v.05	間に合う、あるいは到達するのに失敗する
PWN:miss.v.06	それなしで
PWN:miss.v.07	達しない
PWN:miss.v.08	不在である
PWN:mistake.n.01	まずい判断や怠慢、不注意を原因とする誤った行動
PWN:mister.n.01	男性のための敬称
PWN:mix.v.04	追加の要素または部分として付け加える
PWN:model.n.01	複雑な本質、または過程における仮説に基づいた説明
PWN:model.n.04	（時に縮小された規模での）物の表現
PWN:modern.a.01	現代の時代に属するさま
PWN:moisten.v.01	湿らす
PWN:molar.n.01	歯冠が広い、噛み砕くための歯
PWN:mold.n.05	湿り気のある、または腐食している様々な種類の有機物質の表面に増殖する菌
PWN:mole.n.06	小さな眼と穴を掘るのに適した前肢を持つ、なめらかな毛皮で覆われた小型の穴居性哺乳動物
PWN:molecule.n.01	元素または化合物の最も単純な構成単位
PWN:molybdenum.n.01	クロミウムおよびタングステンと性質が似た、多価の金属元素
PWN:moment.n.01	特定の時点
PWN:monday.n.01	週の2番目の日
PWN:money.n.01	最も普通に使われている交換手段
PWN:monkey.n.01	（原猿類を除く）様々な長い尾を持つ霊長類
PWN:monster.n.01	想像上の生き物で、普通は人間や動物の様々な部位からできている
PWN:moon.n.01	地球の天然衛星
PWN:moor.n.02	通常、ヒースとワラビと苔に覆われている泥炭質の平原
PWN:more.a.01	サイズ、量、範囲または程度において大きさを意味する数値化
PWN:more.a.02	総がより大きいということを意味する数量詞
PWN:morning_glory.n.01	じょうご型の花が午後には閉じてしまう巻きつきつる植物の総称
PWN:morning.n.01	夜明けから正午までの時間
PWN:mortar.n.02	石造建築または壁塗りに使われる
PWN:mortar.n.03	すりこぎを使ってものをすりつぶすボウル形の容器
PWN:mosque.n.01	通常、光塔があるイスラム教の教会
PWN:mosquito_net.n.01	蚊から守るための細かい網または薄い一枚（特にベッドの周りで）
PWN:mosquito.n.01	雌は人間と動物の皮膚を突き刺し血を吸うための長い吻を持つ双翅目の昆虫
PWN:most.a.01	総計で最も大きいということを意味している数量詞
PWN:most.r.01	最高な物を形成するのに使用される
PWN:mother-in-law.n.01	配偶者の母親
PWN:mother.n.01	子供を生んだ女性（また人の母親を指す言葉にも使われる）
PWN:motor.n.01	他のエネルギー形態を機械力に変換して、動きを伝えるマシン
PWN:motorcycle.n.01	2輪と強いフレームを持つ自動車
PWN:mountain.n.01	周りのものを超えて目立つ土地の塊
PWN:mouse.n.01	細く通常は毛のない尻尾を持つ細長い体に先のとがった鼻と小さな耳を持つ小型のネズミに通常似ている数々の小型のげっ歯類のどれか
PWN:mouth.n.01	そこを通して食物が取り入れられ、発声が生じる開口部
PWN:mouth.n.04	流れがより大きな水域に出るところ
PWN:move.v.02	新しい位置または場所に動かす、あるいは移動させる、具体的および抽象的な意味でも
PWN:move.v.03	位置を変えるために動く、そして、並進運動ではない動きを実行する
PWN:move.v.04	住居、所属または雇用の場所を変える
PWN:movie.n.01	音によって、または連続して動いているという錯覚をおこす画像の連続によって物語に動きを与える娯楽の形態
PWN:mow.v.01	刃か草刈り機で切る
PWN:mrs.n.01	結婚している女性の敬称
PWN:ms.n.05	女性の敬称
PWN:much.a.01	量、程度、範囲が非常に大きい
PWN:mud.n.01	水がしみた土
PWN:mule.n.01	雄のロバと雌の馬の雑種の子
PWN:multiply.v.01	掛け算によって合わせる
PWN:mumble.v.01	不明瞭に話す
PWN:muntjac.n.01	小さな角を持ち、吠えるようになく小さなアジアの鹿
PWN:murder.n.01	人間による不法な計画殺人
PWN:muscle.n.01	身体の収縮器官の1つ
PWN:museum.n.01	科学的、歴史的、あるいは芸術的に価値のあるものを蒐集し展示するための保管所
PWN:mush.n.02	ひき割りトウモロコシを湯で煮たもの
PWN:mushroom.n.02	キノコと関連した肥満した菌類（毒キノコ、ホコリタケ、イヌホオズキ、珊瑚菌類、その他を含むこと）
PWN:mushroom.n.05	多肉質の食用キノコ類
PWN:music.n.01	構造化され、かつ連続的な楽器あるいは音声から成る聴覚コミュニケーションの芸術的形態
PWN:music.n.04	歌手や楽器によって生じる音（あるいはそのような音の再生）
PWN:musician.n.01	（専門職として）楽器を演奏する人
PWN:muslim.n.01	イスラム教の信者または支持者
PWN:mussel.n.01	ワインで蒸して食べる黒い海洋の二枚貝
PWN:mustache.n.01	上唇の上の剃っていない毛
PWN:mustard.n.01	アブラナ科アアブラナ属の数種の植物の総称
PWN:mustard.n.02	カラシの種子をひいたピリッとする粉やペースト
PWN:mutual_opposition.n.01	2つの対立した特性または傾向の関係
PWN:mystery.n.01	理解するすべがなく説明できないもの
PWN:nail.n.01	指の背面の一部を覆い保護する、角質の板
PWN:nail.n.02	ハンマーで材に打ち込んで留め金として働く、薄く尖った金属部品
PWN:name.n.01	ある人または物が認識される、言語の最小構成単位
PWN:name.v.01	指定された（通常適切な）正式名称を割り当てる
PWN:nape.n.01	首の後面
PWN:narrative.n.01	出来事の行為、発生、詳細、進行を伝えるメッセージ
PWN:narrow.a.01	広くない
PWN:native.a.01	地理的起源によって存在するまたは特徴てきな
PWN:natural_elevation.n.01	高い、または高くした地形
PWN:nature.n.03	動植物、風景などを含む自然な物質的世界
PWN:nature.n.04	その人特有の行動や反応を決定する感情的、知的特質の複合体
PWN:navel.n.01	へその緒がついていた傷痕
PWN:navy.n.01	国に属し、海戦のためにある軍艦の編成
PWN:near.a.01	時間、空間、程度、状況がはるかに遠くない
PWN:near.r.01	時間または場所または関係において近い
PWN:necessary.a.01	必要不可欠な
PWN:necessity.n.01	必須であるか緊要の状況
PWN:neck.n.01	身体の残りに頭を接続する有機体（人間または動物）の一部
PWN:necklace.n.01	装飾（特に女性によって）として首につけられるコードまたはチェーン（しばしば、宝石をつけている）からなる宝石
PWN:necktie.n.01	（たいてい男子によって）カラーの下に付けられ前で結ばれる一枚の小幅の長い生地
PWN:need.v.03	必要性を持っているか、または感じる
PWN:needle.n.03	鋭くとがった道具（ふつうは鋼鉄）
PWN:negative.a.01	否定、否認、反対または抵抗により特徴付けられるか、または示すさま
PWN:negative.s.08	負電荷を持つさま
PWN:neighbor.n.01	誰か他人の近くに住んでいる人
PWN:neodymium.n.01	黄色の3価の希土類金属元素
PWN:neon.n.01	無色、無臭の気体元素で、真空管の中では赤い光を放つ
PWN:nephew.n.01	兄弟か姉妹の息子
PWN:neptunium.n.01	放射性超ウラン金属元素
PWN:nerve.n.01	さまざまな身体の器官と組織を通る神経繊維の束
PWN:nest.n.01	動物がその中で産卵あるいは子供を産む構造物
PWN:net_income.n.01	ある一定の期間内で出費を超える収益の超過部分（減価償却と他の非現金出費を含む）
PWN:net.n.02	魚、鳥、昆虫を捕獲するために網を用いたわな
PWN:net.n.06	糸、紐、針金が一定の間隔でしっかりと編まれた目の粗い織物
PWN:nettle.n.01	触れると皮膚の炎症を起こす毛刺毛を持つ、多数の植物の総称（特にイラクサ属またはイラクサ科の）
PWN:neuter.a.01	文法的性の
PWN:neuter.s.02	性器を有さないこと、あるいは不完全に発達した、機能しない性器を有するさま
PWN:never.r.01	かつてないさま
PWN:new_year.n.01	暦年がちょうど始まった
PWN:new.a.01	長い期間でない
PWN:news.n.01	最近の重要な出来事の情報
PWN:newspaper.n.01	折り畳まれた紙に書かれた日刊または週刊の出版物
PWN:nice.a.01	性質または外観が快活な、愉快な、あるいは感じのよい
PWN:nickel.n.01	耐腐食性のある、可鍛性の硬い銀色の金属元素
PWN:niece.n.01	兄弟や姉妹の娘
PWN:night_shift.n.01	夜間の勤務時間（真夜中から午前8時までのように）
PWN:night.n.01	外が暗い、日没の後と日の出の前の時間
PWN:nine.s.01	8より1多く10より1少ないもので構成される数の表示
PWN:ninety.s.01	80よりも10多い
PWN:niobium.n.01	柔らかで灰色の延性に富んだ金属元素で、合金に用いられる
PWN:nipple.n.01	乳腺の小さな突起
PWN:nit.n.02	特に吸引するシラミなどの、哺乳類につく寄生虫の若いもの、または卵
PWN:nitrogen.n.01	通常、無臭、無色で無味の不活性の二分子の気体である共通非金属元素
PWN:no.a.01	限量詞
PWN:no.r.03	拒否、否定または不一致などを示すか、または特に否定的声明を強調するために、使用されます
PWN:nobelium.n.01	キュリウムをカーボン・イオンで照射することによって合成される放射性超ウラン元素
PWN:noise.n.01	あらゆる種類の音（特に曖昧な音や不協和音）
PWN:noise.n.01	あらゆる種類の音（特に曖昧な音や不協和音）
PWN:nonfat.a.01	脂肪のない、または固形脂肪のない
PWN:noon.n.01	真っ昼間
PWN:noon.n.01	真っ昼間
PWN:noose.n.02	引結びによってコードかロープで形成された輪
PWN:normal.a.01	標準または規格またはレベルまたはタイプまたは社会規範と一致する、あるいは、標準または規格またはレベルまたはタイプまたは社会規範を構成する
PWN:north.n.03	0度または360度を示す、基本的な羅針盤の方位
PWN:nose.n.01	臭覚の器官で、気道の入口
PWN:nostril.n.01	鼻にある鼻腔への2つの開口部
PWN:not.r.01	単語または単語の集まりの否定
PWN:not.r.01	単語または単語の集まりの否定
PWN:note.n.01	簡潔に書かれた記録
PWN:novel.n.01	散文で書かれた長い虚構の作品
PWN:november.n.01	10月の後、12月の前の月
PWN:now.r.04	現時点において
PWN:number.n.02	ゼロと単位を含む、量の概念
PWN:nurse.n.01	（通常は医者の指示で）幼児または病人を看護するのに熟練した人
PWN:nut.n.01	一般に大きくて堅い外皮の種子
PWN:oak.n.01	オークの堅く耐久性のある木材
PWN:oak.n.02	カシ属の落葉樹
PWN:oak.n.02	カシ属の落葉樹
PWN:oar.n.01	ボートを推進するか、操縦するのに用いられる道具
PWN:oat.n.01	ヨーロッパと北アフリカの一年生の草
PWN:oath.n.03	通常神の証人を呼び起こして、将来の行為や行動に関す神聖な誓い
PWN:obey.v.01	従順である
PWN:object.n.01	触れることができて目に見える実体
PWN:obscure.s.01	明確に理解されないか、または表現されない
PWN:obscure.s.01	明確に理解されないか、または表現されない
PWN:obscure.s.04	有名でない、または絶賛されていない
PWN:occupation.n.01	金銭を稼ぐために行う生活の中での主要な活動
PWN:occupy.v.02	（ある場所に）住む
PWN:ocean.n.01	水圏の主要な部分で成る大きい水域
PWN:october.n.01	9月の後で11月の前
PWN:official.a.01	職権、および認可のある
PWN:oil.n.01	水と融和しない、物を滑らせやすいまたは粘性のある液体あるいは液状化する物質
PWN:oil.n.01	水と融和しない、物を滑らせやすいまたは粘性のある液体あるいは液状化する物質
PWN:ointment.n.01	半固形製剤（通常、薬を含む）で、治療薬として、または、炎症を鎮静化するために外用される
PWN:okra.n.01	オクラ植物の長くて緑色の食用の突き出しているさや
PWN:okra.n.02	スープとシチューの基礎として使用される長い粘液質の緑色のさやのために南米国と西インド諸島を広く耕作された旧世界熱帯の高い粗い年次
PWN:old_man.n.01	非常に年老いた男性
PWN:old_woman.n.01	歳を取った女性
PWN:old_world_buffalo.n.01	水牛などを含む雄牛に似た数種の旧大陸の動物のどれか
PWN:old_world_vulture.n.01	アフリカとユーラシアのいくつかの大きなハゲワシのどれか
PWN:old.a.01	（特に人々に使用される）比較的長い時間生きているか、または特定の年齢に達するさま
PWN:old.a.01	（特に人々に使用される）比較的長い時間生きているか、または特定の年齢に達するさま
PWN:old.a.02	長期の
PWN:olfactory_property.n.01	嗅覚器官によって感知される特性
PWN:olive.n.01	ヨーロッパのオリーブの小さい卵型の実
PWN:omen.n.01	何かが起こる前のしるし
PWN:once.r.01	ある時
PWN:once.r.03	前回に
PWN:one-half.n.01	割り切れる全体の2等分の1
PWN:one.s.01	一つの単位または物に用いられる
PWN:onion.n.02	丸い食用の球根のために世界中で耕作される空洞状の葉を持つ球根植物
PWN:open.a.01	妨害されていない入口と出口の存在を持つさま
PWN:open.v.01	開ける、または開いてしまうようにする
PWN:opinion.n.01	証拠または確証の基づかない個人的信条または判断
PWN:opossum.n.02	むきだしのものをつかむのに適している尾を持つ北アメリカ南部から南アメリカ北部までに見られる夜行性の樹上に住む有袋類
PWN:opportunity.n.01	状況の好ましい組み合わせによる可能性
PWN:oppose.v.01	反対である
PWN:oppress.v.01	権威を不当に使用して咎める、または抑圧する
PWN:orange.n.03	オレンジを実らせるカンキツ類の高木
PWN:orange.s.01	赤と黄色の間の色の
PWN:orchestra.n.01	弦楽器奏者を含む、器楽奏者の集団から成る音楽の団体
PWN:order.v.01	権威を持って誰かに何かをさせるための指示を与える、または指示する
PWN:order.v.01	権威を持って誰かに何かをさせるための指示を与える、または指示する
PWN:ordinary.a.01	特に質、能力、大きさまたは度合において例外的ではない
PWN:oregano.n.01	芳香性のユーラシアの多年草
PWN:organ.n.01	特定の機能に分化した動物の完全に差別化された構造上、機能上の単位
PWN:organic.n.01	動物または植物質からもたらされる肥料
PWN:organize.v.02	何らかの主義または考えを基に構成され、命令されまたは機能するようになされる
PWN:original.s.01	時間において他のすべてに先んじるまたは最初に作られた、または行われた
PWN:original.s.04	何か別のものから派生していない、コピーされていない、あるいは翻訳されない
PWN:orphan.n.01	両親をなくした子供
PWN:osmium.n.01	堅くて脆い青灰色、または濃い藍色の金属元素で、白金族の1つである
PWN:other.a.01	既に述べた、または示したのと同じものではない
PWN:outer.a.01	外側に、または、さらに中心からであるさま
PWN:outrigger.n.01	カヌー用の安定装置
PWN:outside.r.01	建物の外で
PWN:oven.n.01	ベーキングまたはローストのために使われる台所機器
PWN:overlord.n.01	他人に対して全般的な権限を持つ人
PWN:overlord.n.01	他人に対して全般的な権限を持つ人
PWN:overmuch.r.01	必要以上に
PWN:owe.v.03	借金する
PWN:owl.n.01	タカのようなくちばしとツメに正面を向く眼がある大きな頭を持つ夜行性の猛禽
PWN:own.v.01	所有権または、の所持
PWN:owner.n.01	（法的占有者である）企業を所有する人
PWN:ox.n.01	ウシ属の去勢された大人の雄牛
PWN:oxygen.n.01	2価の非金属元素で、通例無色、無臭、無味の不燃性の二原子気体
PWN:oyster.n.01	粗い不ぞろいの殻を持つ海産軟体動物
PWN:paca.n.01	南・中央アメリカ産の穴居性の大型齧歯動物
PWN:package.n.01	一緒に包装されたり箱に入れられたりしている物の集まり
PWN:paddle.n.04	カヌーまたは小さなボートを推進させるためのオール受けなしで使用される短く軽いオール
PWN:paddy.n.02	稲を育てる、灌漑された、あるいは水を張った畑
PWN:padlock.n.01	取り外し可能な錠
PWN:page.n.01	1枚の葉（本または雑誌または新聞紙または手紙その他の。）の一方またはそれが含む書面にしたか絵の問題
PWN:pain.n.03	激しい苦痛に対する体性感覚
PWN:paint.n.01	表面の保護、または装飾用にコーティングとして使用される物質（特に液体に懸濁される顔料の混合物）
PWN:paint.v.02	塗料を塗る
PWN:paint.v.02	塗料を塗る
PWN:paintbrush.n.01	アプリケーター（ペンキを使用するために）として使われるブラシ
PWN:pair.n.01	一まとまりと見なされる2つの類似の物の1組
PWN:palette.n.01	特定の芸術家、絵または美術の流派の色の特性の範囲
PWN:palette.n.02	平らな面を持ち、芸術家がその上で使用する塗料や絵の具を混ぜる板
PWN:palladium.n.01	プラチナに似た白金族の銀白色の金属元素
PWN:palm.n.01	手首から指の底面までの手の内側の表面
PWN:palm.n.03	大きな羽状または掌状の葉の茂る枝のない幹を持つヤシ科の植物のどれか
PWN:pan.n.01	広い金属容器からなる料理用具
PWN:paper.n.01	セルロースパルプで作られる素材で、主に木、古着またはある種の草から得られる
PWN:parallel.a.01	いたる所が距離が等しく、交差していない
PWN:pare.v.04	角を取り除き、好みのサイズに切り刻む
PWN:parent.n.01	父親か母親
PWN:park.n.01	公共財産として自然な状態で保存された広い地域
PWN:parliament.n.01	ある国々における立法府
PWN:parrot.n.01	短いかぎ形のくちばしと音を模倣する能力のある対指足類の熱帯鳥
PWN:part.n.02	加工品全体よりも少ないもの
PWN:part.n.03	自然物の一部
PWN:partake.v.02	の株式を持つ、与える、または、受ける
PWN:partridge.n.03	小型の古代キジ類の狩猟鳥
PWN:parturition.n.01	分娩の過程
PWN:party.n.01	政権を獲得する組織
PWN:pass.n.05	どこかを通行するまたはどこかへ行く許可
PWN:passeridae.n.01	真性のスズメ：以前はハタオリドリと考えられていた旧世界の鳥
PWN:past.n.01	経過した時間
PWN:pasta.n.02	小麦粉、水と時々卵で成るかたどられた乾燥したパン生地
PWN:paste.n.01	柔らかで可鍛性の粘稠度を持つ混合物
PWN:pasture.n.01	芝や牧草に覆われ、家畜の放牧に適した場所
PWN:patch.n.03	装飾、穴を繕ったり塞ぐものとして使用される布の断片
PWN:path.n.02	特定の使用のために特に設計された道
PWN:path.n.03	往来や出入りのために作られた進路
PWN:patience.n.01	動作の遅さまたは能力がないことに対する温厚な寛大さ
PWN:paw.n.01	動物、特に四肢動物の鈎爪のある足
PWN:pawn.n.01	保証として供託する物品
PWN:pawn.n.03	最も弱い駒
PWN:pay.v.01	通常商品またはサービスと引きかえに、お金を与える
PWN:pea.n.01	エンドウの実
PWN:pea.n.03	食用の緑の種子を含む長い緑のさやと小さな白い花を持つエンドウ属のマメ植物
PWN:peace.n.01	戦争のないときの一般的な状態
PWN:peak.n.04	何かの頂点または極点（通常山または丘）
PWN:peak.n.04	何かの頂点または極点（通常山または丘）
PWN:peanut.n.01	ラッカセイの地中の莢
PWN:pear.n.01	異種の多い、水気の多い甘い、ザラザラした質感の果物
PWN:pearl.n.01	二枚貝ないしは牡蠣の貝の中にできる、なめらかな光沢のある丸い構造物
PWN:peck.v.01	つまむ動作で軽くたたく
PWN:pedal.n.02	足で動くレバー
PWN:peel.n.02	果物や野菜の皮
PWN:peg.n.01	表面に刺された、または打ち込まれた木くぎ
PWN:pen.n.01	インクが流れ出てくる先で書く道具
PWN:pencil.n.01	細い円柱の先のとがった筆記用具
PWN:penguin.n.01	水かきのある足とフリッパーとして変化した翼がある寒冷の南部特に南極地方の短い脚の飛べない鳥
PWN:penis.n.01	男性の交接器官
PWN:people.n.01	（複数形）集合的に人間（男や女、または子供たち）のグループ
PWN:pepper.n.01	はん縁性植物、完熟すると濃赤色になる実（コショーの実）をつける
PWN:pepper.n.03	東インド産の一般的なコショウの実からとった辛い調味料
PWN:perca.n.01	パーチ科の標準属
PWN:perceive.v.01	感覚を通じて気が付くようになる
PWN:periphery.n.01	境界線の外側、もしくはものの表面
PWN:perjury.n.01	宣誓の下で虚偽の陳述をする刑事犯罪
PWN:permanent.a.01	状態、条件、または場所を大きく変えることなく続く、または持ちこたえる
PWN:permit.v.01	同意し、許可する
PWN:person.n.01	一人の人間
PWN:perspiration.n.01	汗腺によって分泌される塩気のある液体
PWN:perturb.v.01	心の錯乱、不安で、心配になり、不安定になる
PWN:pestle.n.03	乳鉢で物質を砕き混ぜるためのこん棒のような形の道具
PWN:pet.n.01	慰み用・愛玩用に飼い慣らされた動物
PWN:petroleum.n.01	主に炭化水素から成る暗色の油
PWN:petroleum.n.01	主に炭化水素から成る暗色の油
PWN:phobia.n.01	単純なものまたは社会的状況に対する極度の恐怖または不合理な恐怖により特徴づけられる不安障害
PWN:phone.n.02	いくつかの言語の音素であるかどうかは特定しない、言語の個々の音声単位
PWN:phosphorus.n.01	無機リン酸塩灰岩で、また、すべての生きている細胞の中の有機リン酸塩として一般的に起こる窒素族の多価の非金属元素
PWN:photograph.n.01	人物あるいは場面のプリントまたは透明なスライドの形の表現
PWN:photograph.v.01	写真用フィルムに記録する
PWN:photograph.v.01	写真用フィルムに記録する
PWN:piano.n.01	鍵盤を押し下げるとハンマーが調律された弦をたたいて音を出す、という仕組みで演奏される鍵盤楽器
PWN:pick_up.v.02	手で巻き取る
PWN:pick.v.02	探して集める
PWN:picture.n.01	表面に作成された視覚表現（物、場面、人または抽象概念の）
PWN:picture.n.01	表面に作成された視覚表現（物、場面、人または抽象概念の）
PWN:pier.n.01	海岸から水のある方へ突き出て作られた、柱で支えられた台
PWN:piggyback.v.04	背中と肩を支える
PWN:pike.n.02	脂肪の少ない貴重な北の淡水魚
PWN:pile_up.v.02	山積みまたは積み上げるようにする
PWN:pile.n.01	互いに積み重ねて置かれた物の集まり
PWN:pill.n.02	小さな小球の形の薬の一服
PWN:pillow.n.01	寝ている人の頭を支えるためのクッション
PWN:pinch.v.01	きつく指の間をきつく絞る
PWN:pine.n.01	針葉樹
PWN:pink.s.01	赤の淡い色合いの
PWN:pipe.n.01	小さなボウルが一端にあるチューブ
PWN:pipe.n.02	水、油、ガスなどを運ぶために用いられる金属やプラスチックの長い菅
PWN:piquant.s.01	快い刺激的な味のある
PWN:piranha.n.02	生きた動物を襲い殺す南米産の貪欲な肉食性小型淡水魚
PWN:pit.n.01	（ふつう地面に掘られた）かなり大きい穴
PWN:pitch.n.01	音響振動の周波数の変動によって変化する音の特性
PWN:pitch.n.06	残留物として得られる暗色の重いねばねばした物質の総称
PWN:pitcher.n.01	投球する選手
PWN:pitcher.n.02	注ぐための柄と口がついた蓋のない容器
PWN:pitchfork.n.01	干し草を積み上げるための鋭く間隔のあいたフォークのついた長柄の道具
PWN:pizza.n.01	薄いパンの練り粉に香料入りトマトソース・チーズを混ぜたものを塗って焼いたイタリアのオープンパイ
PWN:plain.n.01	平らで開けた土地の広範囲に及ぶ地帯
PWN:plaintiff.n.01	法廷に訴訟を起こす人
PWN:plan.n.01	実行するための一連の段階あるいは達成するべきゴール
PWN:plane.n.02	限りない2次元の形
PWN:planet.n.01	太陽の周りを公転し、反射光によって輝く太陽系の9つの大きな天体のいずれか
PWN:plant.n.02	移動力のない、生命を持つ有機体
PWN:plant.v.01	（種子、苗、または植物）を地面に埋める、または植えつける
PWN:plastic.n.01	一定の形の物や皮膜や単繊維に成形したり、例えば被覆剤や接着剤を作るのに使われる合成または半合成物質の総称
PWN:plate.n.04	食べ物を出したり食べたりする皿
PWN:platinum.n.01	重貴金属元素
PWN:play.n.01	ステージでの俳優による演技を目的とする劇の仕事
PWN:play.n.08	決まったルールよりも想像力に導かれるような子供の遊び
PWN:play.v.01	ゲームかスポーツに参加する
PWN:play.v.03	楽器を演奏する
PWN:play.v.05	遊んでいる
PWN:play.v.12	ゲームや娯楽の活動の中で誰かになったふりをする
PWN:play.v.18	録音されたオーディオまたはビデオを発表させる
PWN:plaything.n.01	遊ぶために考案された人工品
PWN:pleasure.n.01	定義しにくいが人々が経験したいと思う根本的な感情
PWN:plot.n.01	何か（特に後ろ暗いこと、非合法なこと）をするための秘密の計画
PWN:plover.n.01	比較的小型な造りと大きなとがった翼の、まっすぐなくちばしがある主に多数の海辺の鳥
PWN:plow.n.01	土地を耕して、植え付ける前に溝を切るための一つ以上の重い刃のある農具
PWN:plow.v.01	特に鋤で地面を耕し、すき返す
PWN:plug.n.01	しっかり穴を塞ぐように設計された物からなる妨害物
PWN:plum.n.01	堅い単核を持つ滑らかな表面で卵形をした食用果実を実らせる高木の総称
PWN:plutonium.n.01	中性子によって砲撃されると原子を分けることができる固体の銀の灰色の放射性超ウラン元素
PWN:pocket.n.01	小物を運ぶための上着についている小袋
PWN:pod.n.01	種子が入っている容器（種子そのものではない）
PWN:poem.n.01	リズミカルな詩句を作る、韻脚で書かれた詩
PWN:poet.n.01	詩を書く人（通常、この言葉は優れた詩を書く人を指す）
PWN:pointed.a.01	尖端持つさま
PWN:poison.n.01	生物体の損傷、病気、あるいは死を引き起こす物質の総称
PWN:polarity.n.02	（電極の陽極、陰極という区別のように）明示された極を持っていること
PWN:pole.n.01	木、金属、プラスチックの長い（普通は円みのある）棒
PWN:police.n.01	警察官と警官の力
PWN:policeman_bird.n.01	大型のたいてい白いオーストラリアコウノトリ
PWN:policeman.n.01	警察のメンバー
PWN:political_campaign.n.01	公選職の候補の間のレース
PWN:politics.n.01	権威または権力にからんだ社会的関係
PWN:politics.n.05	国または政府を統括することに従事する行動または事柄
PWN:pollute.v.01	不潔にする
PWN:polonium.n.01	テルルとビスマスと類似している放射性金属元素
PWN:pompon.n.01	ボール、房状の羊毛、または絹からなるデコレーション
PWN:poncho.n.01	頭を通すために真ん中に穴を開けた、毛布のようなマント
PWN:pool.n.01	（普通）水が一杯の穴
PWN:poor.a.02	お金または所有物がほとんどないさま
PWN:populace.n.01	一まとまりとして見なされる一般の人々
PWN:populate.v.01	居住するか、生きる
PWN:populate.v.01	居住するか、生きる
PWN:porch.n.01	建物の外にしばしばひさしのある玄関を作っている建築物
PWN:port.n.01	（海港、空港など）人々や商品などが国に入ったり出たりする場所
PWN:position.n.01	ある物質によって占められている空間的な部分
PWN:position.n.07	何かが存在する場所またはやり方の空間的特性
PWN:positive.a.01	肯定、容認、または確信などが特徴の、またはそれらを見せるさま
PWN:positive.s.10	正電荷を持っているさま
PWN:possession.n.02	所有または占有されている物
PWN:possible.a.01	起きるまたは存在できる
PWN:possibly.r.01	偶然に
PWN:post_office.n.01	郵便業務が利用できる支部
PWN:post.n.01	人が（警備または歩哨として）立つ、または立つように指定される位置
PWN:post.n.04	しっかりと直立位置に固定されている材木や金属からなる直立物
PWN:postage.n.02	郵便の料金が払われたそれを示すために手紙か小包に貼り付けられる小さな粘着性の印
PWN:postcard.n.01	封筒に入れずに郵便でメッセージを送るためのカード
PWN:pot.n.01	普通丸くて深い金属あるいは陶器の料理の鍋
PWN:potassium.n.01	アルカリ金属グループの軽い軟質の銀白金属元素
PWN:potato.n.01	南米原産の食用塊茎
PWN:potter.n.01	ろくろで陶器を形作り窯で焼く工芸家
PWN:pouch.n.01	物を保持するかまたは運ぶための小さいまたは中間のサイズ容器
PWN:pour.v.01	走らせる
PWN:powder.n.01	小さくて遊離した粒子の形態における固体物質
PWN:power.n.01	影響を支配する所有権
PWN:power.n.02	仕事をするときの工率
PWN:powerful.a.01	大きな力、腕力、効力、または効果を持つ
PWN:prairie_dog.n.01	北米の大草原に生息する数匹の齧歯動物で、大きな込み合った巣穴で生活をし、吠えるように鳴く
PWN:prairie.n.01	樹木のない草原
PWN:praise.n.01	承認と賞賛の表現
PWN:praise.v.01	好意的な感情を表す
PWN:praseodymium.n.01	柔らかく黄色味を帯びた白色の3価の希土類金属元素
PWN:prawn.n.01	様々な食用の十脚甲殻類
PWN:pray.v.01	神、預言者、聖人または崇拝の対象に直接問う
PWN:preach.v.01	説教する
PWN:precipice.n.01	非常に急な崖
PWN:prefer.v.01	より好む
PWN:pregnant.a.01	体に発達中の子供を持つ、または、新しい生命を作り出す
PWN:present.a.01	時間的な感覚
PWN:present.a.02	指定された場所にいる、または存在する
PWN:present.n.01	現在起こっている時間
PWN:president.n.01	企業や会社の役員
PWN:president.n.03	共和国の最高行政官
PWN:president.n.03	共和国の最高行政官
PWN:press.v.01	圧迫を加える、強制する、あるいは力を加える
PWN:pressing.s.01	緊急行動を余儀なくさせる
PWN:prevent.v.01	起きてしまうことまたは発生することを防ぐ
PWN:prevent.v.02	（誰かがまたは何かが）何かすることをまたはある状態を止めさせる
PWN:previous.s.01	時間または順序で何かに先んじる
PWN:price.n.02	何かを買うのに要する金額
PWN:pride.n.01	自尊心および、自分に値打ちがあると感じること
PWN:priest.n.01	様々な宗教的な儀式を行う、あるいは管理する権限があるキリスト教の教会の聖職者
PWN:priest.n.02	非キリスト教の宗教で宗教的義務と式典を行う人
PWN:prime_minister.n.01	英国の首相の地位にある人
PWN:prime.n.01	因数がその数自身と1のみの数
PWN:print.v.04	印刷による再生
PWN:prison.n.01	裁判中にまたは罰として監禁される矯正施設
PWN:prisoner.n.01	閉じこめられた人
PWN:private.a.01	特定の人、グループに制限された、あるいはプライバシーを提供するさま
PWN:prize.n.01	コンテストまたは競争の勝利または優勢のために、または、宝くじに勝つと与えられる何か
PWN:probable.a.01	有力だが、真実であるまたは実在的であるか、真実になる、あるいは実在的になることが確かでないさま
PWN:problem.n.01	解決する必要のある困難な状況
PWN:procedure.n.01	結果を達成しようと試みた、ある特定の行動の過程
PWN:produce.v.02	人工の製品を作成または製造する
PWN:program.n.08	公開の発表での演技（または一連の上演）
PWN:project.n.02	計画された事業
PWN:promethium.n.01	安定した同位元素を持たないまれな土群の柔らかい銀質の鉄分要素
PWN:promise.n.01	ある人から他の人への、将来において何かをする（あるいはしないという）口頭による約束
PWN:promise.v.01	約束する、または、誓約する
PWN:proof.n.01	何かの真実を確立するのに役立つ、事実に基づく証拠
PWN:propose.v.01	提案する、計画を表明する
PWN:prostitute.n.01	お金のための性交に従事している女性
PWN:protactinium.n.01	短寿命の放射性の金属元素で、ウランから生成され、アクチニウム、そして鉛に分解する
PWN:protect.v.01	危険、けが、破壊または損害からの防御
PWN:protest.n.01	正式で厳粛な異議の宣言
PWN:prototype.n.01	標準的、典型的な例
PWN:proud.a.01	何かにおいて自己価値を評価することで自尊心または喜びを感じる
PWN:proverb.n.01	簡略されているが記憶すべき言いならわしで、多くの人々が真実と考える経験上の重要な事実を表している
PWN:pry.v.01	特にある物を開けるために動かす、または力ずくで押す
PWN:pubic_hair.n.01	恥部に生えている毛
PWN:public.a.01	個人的でない
PWN:pull.v.01	引くことにより動きを引き起こす
PWN:pulley.n.01	ロープに適用された力の適用の方向かポイントを変更するために、ロープが走ることができる溝を備えた車輪から成る単一機械
PWN:pump.n.01	圧力や吸引力で流体やガスを移動させる機械装置
PWN:punish.v.01	処罰を加える
PWN:punishment.n.01	罰する行為
PWN:pure.a.01	いかなる種類の副次的要素がない
PWN:pure.s.07	性の純潔の状態
PWN:purple.s.01	赤と青の間で中間の色の
PWN:pursue.v.02	を追いかける、あるいは、求めるかのような
PWN:pus.n.02	炎症によって作り出される分泌液
PWN:push.v.01	力による動き、
PWN:put.v.01	ある一定の場所または抽象的な場所に置く
PWN:put.v.01	ある一定の場所または抽象的な場所に置く
PWN:pyramid.n.01	多角形の底面と同一の頂点で交わる三角形の面をもつ多面体
PWN:pyre.n.01	葬式のときに死体を焼くために積まれた薪
PWN:python.n.01	大型旧世界産ボア類
PWN:quail.n.02	小型のキジ類の猟鳥
PWN:quality.n.01	人や物の本質的で特徴的な属性
PWN:quantity.n.03	何かが大きさを持ち、定数または変数で数学的表現によって表現できる考え
PWN:quarrel.n.01	怒って論争すること
PWN:quarrel.v.01	何かについて合意しない
PWN:quartz_glass.n.01	ほぼ純粋なシリカでできた無色のガラス
PWN:queen.n.01	社会性昆虫、例えばミツバチ、アリ、シロアリの群れの唯一の繁殖力のある雌
PWN:queen.n.02	女性の統治支配者
PWN:queen.n.02	女性の統治支配者
PWN:queen.n.08	最強のチェスの駒
PWN:question.n.03	答えを求める質問の文章
PWN:quickly.r.01	急速な動きで
PWN:quiet.a.02	雑音または騒動がない
PWN:quote.v.01	一節を再び述べる
PWN:rabbit.n.01	長い耳と短い尾があるウサギ科の様々なせん孔動物のいずれか
PWN:raccoon.n.02	北・中央アメリカ原産の雑食性の夜行性の哺乳動物
PWN:race.n.01	競争
PWN:race.n.03	同じ遺伝的系統に属すると信じられる人々
PWN:rack.n.01	物を置いておく枠組み
PWN:radio_receiver.n.01	送信された信号を検出し、復調し、そして増幅する電子受信機
PWN:radio.n.01	情報伝達のメディア
PWN:radium.n.01	ウラン鉱石中に微量に存在する、放射性の強い金属元素
PWN:radon.n.01	ラジウムの崩壊で形成された放射性ガスの要素
PWN:raft.n.01	輸送のために、または、泳者のためのプラットホームとして使われることができる平らな浮揚物（通常木または厚板でできている）
PWN:rafter.n.01	屋根を支えるいくつかの平行の傾斜した梁の1つ
PWN:rag.n.01	布または紙の小さな一片
PWN:railing.n.01	水平な横木と支柱からなる柵
PWN:railway.n.01	乗客または貨物輸送をする電車の輸送のシステムの操作に関与する商業的な組織である路線
PWN:rain.n.01	大気中で凝縮された水蒸気から成る滴という形での水の落下
PWN:rain.v.01	雨として落下する
PWN:rainbow.n.01	雨で太陽光が屈折することによって生じる、空にかかる着色光のアーチ
PWN:raise.v.02	低い位置から高い位置に上げる
PWN:rake.n.03	先頭が歯の列になっている長柄の道具
PWN:rake.v.01	熊手を使いながら、または、熊手を使っているかのように進む
PWN:ram.n.05	去勢されていない、成長した雄羊
PWN:rape.n.03	女性の意思に反して性行為に屈しることを女性に強要することの犯罪
PWN:rape.v.01	彼らの意志に反してセックスをさせる（誰か）
PWN:rare.s.04	低い密度を持つさま
PWN:rarely.r.01	めったにない
PWN:rat.n.01	ハツカネズミに似ているが、より大型で長い尾を持つ各種の齧歯動物
PWN:ratio.n.01	2つの量の相対的な大きさ（通常、割合として表される）
PWN:rattle.n.02	振られると打楽器の音のする赤ん坊のおもちゃ
PWN:rattlesnake.n.01	震えたときにガラガラ音をさせる尾の端に角状の部分があるマムシ
PWN:raven.n.01	まっすぐなくちばしと長い楔型の尾を持つ大型の黒鳥
PWN:raw.a.03	食べるための料理に熱処理をしていない
PWN:ray.n.03	一点からのびる直線
PWN:razor.n.01	ひげを剃る際に使われる刃物
PWN:reach.v.01	目的地に着く、実際のまたは抽象のいずれかの
PWN:reach.v.06	そこまで伸びる
PWN:read.v.01	書かれているか、または印刷される何かを解釈する
PWN:ready.a.01	即座に実践、使用または進行のために完全に準備された、またはそのような状態にある
PWN:real.a.01	事実または現実で起きる、またはそのような状態
PWN:reap.v.01	収穫する、自然の生産物として
PWN:rear.n.02	その正面の反対側にある物の側
PWN:rear.v.02	育てる
PWN:reasoning.n.01	首尾一貫した論理的な思考
PWN:receive.v.01	何かを得る
PWN:recently.r.01	最近において
PWN:reciprocal.a.01	二人以上の人、あるいは二つ以上のものについて
PWN:recognize.v.04	同じであると認める
PWN:recommend.v.01	何かを要求する
PWN:record.n.01	過去の出来事に関する永久的な証拠または情報を提供する（文書、レコード録音、写真のような）もの
PWN:rectangle.n.01	4つの直角をもつ平行四辺形
PWN:recuperate.v.04	病気かショックから立ち直る
PWN:red.s.01	色のスペクトルの端の色の（オレンジの隣）
PWN:reed.n.01	特にダンチク属とヨシ属の、中空で細い茎を持つ、背の高い木質の多年生草
PWN:reef.n.01	水面近くの岩またはサンゴの沈没した尾根
PWN:reek.v.02	悪く攻撃的なにおいがする
PWN:referee.n.01	フェアプレーを確実にすることが期待されている主たる役員（ボクシングまたはアメリカンフットボールの）
PWN:refund.v.01	返金する
PWN:refuse.v.01	不本意であることを示す
PWN:refuse.v.02	辞退する
PWN:region.n.01	ものの広がった空間的位置
PWN:regular.a.01	一定の命令または手順または原則に従って
PWN:reject.v.01	受け入れるか、認めることを拒む
PWN:rejoice.v.01	幸福か喜びを感じる
PWN:relation.n.06	個人またはグループ間の相互の付き合いまたはつながり
PWN:relationship.n.01	人々の関係
PWN:relative.n.01	血縁や婚姻による関係のある人
PWN:religion.n.02	神の力への信仰を表現する組織
PWN:religious_holiday.n.01	宗教的行事のために指定されている日
PWN:remainder.n.01	他の部分が取り去られた後に残った物
PWN:remember.v.01	記憶から知識を思い浮かべる
PWN:render.v.01	なる原因
PWN:repair.v.01	部分を取り替えるまたは裂けているか、壊れているものを組み立てることにより修復する
PWN:repel.v.01	力ずくまたは影響により無理やり戻す
PWN:repent.v.02	悔恨を感じる
PWN:represent.v.01	その代わりをする、その類似物である、またはそれと同等のものである
PWN:reptile.n.01	陸生のカメ、水生のカメ、蛇、トカゲ、アリゲーター、クロコダイル、それに絶滅種などを含む爬虫類綱の冷血脊椎動物
PWN:request.v.01	必要性かは欲求を表わす
PWN:rescue.v.01	危害または災いから解放する
PWN:resemble.v.01	ように見える
PWN:respect.v.01	高等であると見なす
PWN:rest.v.05	落ち着いている
PWN:restaurant.n.01	食べに人々が行く建物
PWN:restrain.v.01	支配下においておく
PWN:result.n.03	結果として生じる何か
PWN:result.v.01	（特定のようすや状態等で）生じる、あるいは終わらせる
PWN:retaliation.n.01	被害や犯罪の報いとして取る行動
PWN:revelation.n.03	神性または超自然の代弁による人への知識の連絡
PWN:reverse.n.03	邪魔をするあるいは妨げる不運な出来事
PWN:rhenium.n.01	化学的にマンガンに類似し、いくつかの合金で使用される珍しい重い多価金属元素
PWN:rhinal.a.01	鼻の、鼻における、または、鼻に関する
PWN:rhodium.n.01	白金属の1つである白色の硬い金属元素で、白金鉱石中に存在する
PWN:rhythm.n.01	音楽の基本的なリズムユニット
PWN:rib.n.02	人間の脊椎から胸骨（および脊椎動物の類似の骨）へと延びる湾曲した24の骨のアーチの1つ
PWN:ribbon.n.04	整えるために使用される細長く上質の材料からなる雑貨
PWN:rice.n.01	食用穀類で、精白しないものや何回か精白するものがある
PWN:rice.n.02	一年生または多年生の根茎のある沼地草
PWN:rich.a.01	物質的な富を持つさま
PWN:riddle.n.01	難しい問題
PWN:ride.v.01	通常、動物の動きを制御してその背中に座って旅をする
PWN:ridge.n.06	屋根の2つの傾斜が一番上でぶつかるへりに沿って敷設された梁
PWN:right.a.01	北に面しているとき、体の側面が東側である、に位置する、の方角を向いた
PWN:right.n.01	法律、慣習あるいは自然による人または政府機関のための抽象的観念
PWN:right.r.04	右側の、または右側へ
PWN:rigid.s.01	曲げることができない、または、曲げることに耐性がある
PWN:ring.n.08	指につけられる貴金属（しばしば宝石と一緒に）の輪で成る宝石
PWN:ring.v.01	大きく朗々と鳴り響く
PWN:ring.v.03	しばしば音楽の啓発目的で、（ベル）を鳴らす
PWN:rinse.v.01	石鹸や残っている汚れを洗い落とす
PWN:riot.n.01	抑制のきかない暴徒による公然の暴動
PWN:ripe.a.01	完全に発達した、成熟した、食べられるまたは使われる準備ができている
PWN:ripen.v.01	熟すか、完全に発達させる
PWN:ripen.v.02	実が入る
PWN:rise.v.01	上方に動く
PWN:rise.v.16	天体が昇る
PWN:rite.n.01	宗教によって規定されている、確立された儀式
PWN:river.n.01	広い自然の水流（クリークより広い）
PWN:road.n.01	旅行や輸送用の（一般的に公の）自由な道
PWN:road.n.01	旅行や輸送用の（一般的に公の）自由な道
PWN:roadrunner.n.01	カリフォルニアとメキシコからテキサスまでで見られる素早く広い範囲で生息する鳥
PWN:roar.v.01	風、水または乗り物のように大きな音を出す
PWN:rock.n.01	固い統合鉱物質の塊か固まり
PWN:rock.n.02	地球の地殻を構成しているような鉱物の集合から成る物質
PWN:rock.v.01	前後または横に動く
PWN:rocket.n.01	ロケットエンジンで自己推進する乗り物のどれか
PWN:roentgenium.n.01	放射性超ウラン元素
PWN:roll.v.14	軸に関してひっくり返るか、円形の方法で動く原因
PWN:roof.n.01	建物の最上部をおおうか、形成する保護カバー
PWN:room.n.01	壁、床、天井に囲まれている建物内の区域
PWN:root.n.01	通常は地下部の器管で、芽または葉または節を持たない
PWN:rope.n.01	強い綱
PWN:rosary.n.01	祈りを数えるのに用いられる一連のビーズ（特にカトリック教徒によって）
PWN:rose.n.01	バラの花をつけるバラ属の多くの低木
PWN:rotten.s.03	腐敗した、または、崩壊した
PWN:rough.a.01	不規則な表面を持つ、または、不規則な表面に引き起こされる
PWN:round.a.01	円形をしているさま
PWN:row.v.01	オールで進む
PWN:rub.v.01	圧力とともに何かの上を移動する
PWN:rub.v.03	かゆみを軽減するかのように掻くあるいはこする
PWN:rubber.n.01	いろいろな製品に加硫されることができ、仕上げられる木（特に属パラゴムノキとイチジク属の植物の木）のラテックス樹液から得られる弾力のある材料
PWN:rubbish.n.01	廃棄される、価値のない物質
PWN:rubidium.n.01	アルカリ金属に属する、柔らかい銀色の金属元素
PWN:rudder.n.02	船の船尾に取り付けられてそれを舵をとるために使う蝶番のついた垂直の板
PWN:rug.n.01	厚い重い布地（通常けばまたはパイル織物）からなる床カバー
PWN:rule.n.01	慣習的に行動を支配する原則あるいは条件
PWN:rule.n.12	直線を引き、長さを測定するために使用する、縁がまっすぐの木、金属またはプラスチック片から成る測定用の棒
PWN:ruminate.v.01	反芻する
PWN:run.v.01	自分の足を使って、常時地面から片足を上げ、速く動く
PWN:run.v.06	移動する、液体の
PWN:run.v.06	移動する、液体の
PWN:rush.v.01	速く動く
PWN:rush.v.04	高速度で行動する、または移動する
PWN:rush.v.04	高速度で行動する、または移動する
PWN:rust.n.01	酸素と湿気の作用で鉄や鋼鉄の表面に生じる、赤色または茶色の酸化物
PWN:rustle.v.01	乾いたぱちぱちする音をだす
PWN:ruthenium.n.01	プラチナグループのまれな多原子価金属要素
PWN:rutherfordium.n.01	合成された放射性超ウラン元素
PWN:rye.n.01	穀草の種
PWN:rye.n.02	その粒が北アメリカの主な黒パンの材料、また、飼料と土壌改良の成分となる北ヨーロッパで広く耕される耐寒性一年生植物穀草の芝生
PWN:sabbath.n.01	1日の休息および崇拝：大多数のクリスチャンのための日曜
PWN:sack.n.01	客の購入物を入れるための紙、プラスティックでできた袋
PWN:sacrifice.n.04	神をなだめるために（動物や人間を）殺す行為
PWN:sad.a.01	悲しみまたは不幸を経験するか、示すさま
PWN:safety.n.01	定義された状況下において副作用が一部の抗体に起因しないことが確信されている状態
PWN:safflower.n.01	ユーラシア産のアザミに似た植物で、赤またはオレンジ色の頭花と、高価な油がとれる種が目的で広く栽培される
PWN:sail.n.01	風が帆船を推進させるのに使用される手段による大きな布の織物（通常キャンバス地）
PWN:sail.v.03	水上を風の力で進む
PWN:salad.n.01	いろいろなものを皿に盛り付けたり混ぜ合わせたりしてドレッシングを添える料理
PWN:saliva.n.01	唾液腺と口の粘液腺によって口の中に分泌される澄んだ液体
PWN:salmon.n.01	北の海にすむ様々な大型の食用魚と釣用魚の総称
PWN:salt.n.02	調味と食品保存に使う特に塩化ナトリウムの白い結晶
PWN:salty.s.03	4つの基本的な味覚感覚のうちの1つ
PWN:salvage.v.01	荒廃、破壊または損害から救う
PWN:samarium.n.01	灰色で光沢を持った希土類金属元素
PWN:same.a.01	アイデンティティが同じである
PWN:sand.n.01	粒の岩石かサンゴから成る遊離した物質
PWN:sandal.n.01	紐によって足を固定した靴底からなる靴
PWN:sandglass.n.01	時の経過が細い通路を通って1つのガラス器から別のガラス器へと流れる砂によって示される
PWN:sandwich.n.01	2枚（またはそれ以上）の薄切りのパンの間に詰め物をしたもの
PWN:santa_claus.n.01	子供たちの伝説的な守護聖人
PWN:sap.n.01	植物の維管束系を通して循環する糖、塩、鉱物の水溶液
PWN:satan.n.01	悪の主な精神と神の悪魔
PWN:satanic.a.02	悪魔の、または、悪魔に関する
PWN:satisfaction.n.01	何かを申し分なくやり終えた時に感じる満足
PWN:saturday.n.01	1週間の第7の日、最後の日
PWN:saucer.n.02	テーブルにカップを置くための浅い小さな皿
PWN:sausage.n.01	細かく切った肉に香料をたっぷりときかせ、皮に詰めたもの
PWN:savanna.n.01	熱帯、亜熱帯の平原
PWN:saw.n.02	切断用の歯のついた刃がある
PWN:scabies.n.01	ヒゼンダニによって媒介される伝染性皮膚病
PWN:scale.n.07	重さを量るための計測器
PWN:scale.n.10	多くの動物を覆っている体の部分を形成する平らな堅い板
PWN:scandium.n.01	白い三価金属元素
PWN:scapula.n.01	人間の肩の両側にある2つの平坦な三角形の骨の1つ
PWN:scar.n.01	傷を負った組織の癒えによって残されたマーク（通常、皮膚で）
PWN:scarf.n.01	暖かくするためにあるいは装飾用に頭、首、あるいは肩の回りに付ける衣類
PWN:school.n.01	教育機関
PWN:school.n.02	若者が教育を受ける建物
PWN:science.n.01	科学知識の特定の領域
PWN:scissors.n.01	2枚の刃を旋回芯軸で交差させた刃物
PWN:score.n.03	試合やコンテストでのチームや個人の成績を表す数字
PWN:scorpion.n.03	毒針が先に付いた長い分節に分かれた尾を持つ暖かい乾燥地帯のクモ形類の節足動物
PWN:scrape.v.01	繰り返して引っ掻jく
PWN:scraper.n.01	こするためのさまざまな手工具のいずれか
PWN:screen.n.01	画像が見られるために投影される白または銀色の表面
PWN:screen.n.05	網状の保護被覆
PWN:screw.n.04	先細りの糸を通したシャンクと溝付き頭部があるファスナー
PWN:screwdriver.n.01	ねじを回す手工具
PWN:scripture.n.02	宗教集団により神聖と見なされる著作の総称
PWN:sculptor.n.01	彫刻を創作する芸術家
PWN:scythe.n.01	草を刈るための刃物
PWN:sea.n.01	部分的に陸に囲まれた大洋や広い海水域の一部分
PWN:seaborgium.n.01	超ウラン元素
PWN:seaport.n.01	船が貨物を積み込んだり、荷揚げしたり保護港
PWN:search.v.01	見つけ、発見し、またはその存在を確定しようとする
PWN:search.v.01	見つけ、発見し、またはその存在を確定しようとする
PWN:seashore.n.01	海や大洋の岸
PWN:season.n.02	昼夜平分時と、至点または大気条件によって1年を分ける自然周期の1つ
PWN:seat.v.01	座席に案内する
PWN:second.n.01	1分の1/60
PWN:second.s.01	位置、空間、時間、程度あるいは大きさで最初のもののすぐ後に来るさま
PWN:second.s.01	位置、空間、時間、程度あるいは大きさで最初のもののすぐ後に来るさま
PWN:secret.s.01	公開しない、または公共でない
PWN:secret.s.01	公開しない、または公共でない
PWN:section.n.01	より大きな構成（書物またはミュージカル）の独立した部分
PWN:section.n.04	全体の物を構成するために他と適合するいくつかの断片あるいは部分の1つ
PWN:see.v.01	目で認識する、または目で認識する力を持つ
PWN:see.v.05	そうであると考える
PWN:seed.n.02	植物の胚珠が受精し成熟したもので、胚とその栄養源からなり、保護膜あるいは種皮を持つ
PWN:seek.v.01	得る、または達しようとする
PWN:selenium.n.01	硫黄およびテルルに伴って得られる有毒の非金属元素
PWN:sell.v.01	金銭または等価物のために交換する、または引き渡す
PWN:send.v.01	どこかへ行くようにする
PWN:sense.n.01	意識されていること全般
PWN:sense.n.03	外の世界を理解するのに使われる機能
PWN:sentence.n.01	言語の文法規則を満たす一連の語
PWN:sentence.v.01	裁判所で（人）に判決を言い渡す
PWN:separate.v.02	強制的に分ける、分解する、あるいは引き離す
PWN:september.n.01	8月の後、10月の前の月
PWN:sequence.n.01	物事が論理的順番または連続するパターンで続く連続した配置関係
PWN:series.n.01	類似した事柄が、順番に置かれる、または、次々と起こること
PWN:serious.a.01	遊びまたはつまらないことよりも仕事または重要な事柄に関心のある
PWN:sermon.n.01	宗教的本質の演説（通常、礼拝中に行われる）
PWN:servant.n.01	他人の雑用のために働く人（特に家事において）
PWN:serve.v.01	目的、役割または機能を提供する
PWN:serve.v.10	のために働くか、使用人である
PWN:sesame.n.01	直生の東インドの一年生の草本
PWN:set.n.01	同じ種類のものが一緒になって使用される、もののグループ
PWN:set.n.05	人々やグループの非公式なつながり
PWN:set.v.10	地平線を越えて消える
PWN:seven.s.01	6よりも1多い
PWN:seventy.s.01	60よりも10多い
PWN:severe.s.01	度合いまたは質において、極度にまたは非常に悪いまたは不快な
PWN:sew.v.01	縫うことにより固定する
PWN:sex.n.04	生殖の役割に基づいて生物を区別する特性
PWN:sexual_activity.n.01	性交に関連した行為
PWN:shadow.n.01	明確な境界内の陰
PWN:shake.v.01	前後に動く、または動かす
PWN:shake.v.08	動揺させて、または動揺させるかのようにして、特定の状態に至らせる
PWN:shallow.a.01	物理的な深さを欠く
PWN:shaman.n.01	シャーマニズムを実践する社会において：目に見える世界と精神世界を口寄せするもの
PWN:shame.n.01	欠点または罪に対する意識から生じる苦しい感情
PWN:shape.n.02	実質を除外したある物の空間的配置
PWN:share.n.01	個人または団体によって貢がれる、それらによる、またはそれらに属する資産
PWN:shark.n.01	不等尾型の尾ヒレと小型の歯のようなウロコで覆われた固い皮膚を持つ、細長く、主に肉食性の海洋魚の総称
PWN:sharp.a.09	薄い刃または鋭くとがった先端を持っている、あるいはそれらできているさま
PWN:sharp.a.09	薄い刃または鋭くとがった先端を持っている、あるいはそれらできているさま
PWN:sharpen.v.01	鋭くまたはより鋭く作る
PWN:shatter.v.03	壊して多くの破片にさせる
PWN:shave.v.01	かみそりで体毛を取り除く
PWN:shears.n.01	強い刃の大きなはさみ
PWN:sheath.n.01	（ナイフや剣などを）保護するカバー
PWN:shed.n.01	１階の離れ
PWN:sheep.n.01	ヤギの同類で、羊毛で覆われたたいてい角を持つ反芻哺乳動物
PWN:sheet.n.01	広くて薄い広がりまたは表面
PWN:shelf.n.01	物体を置くための水平な面がある支え
PWN:shell.n.10	軟体動物か腕足類の主に石灰質の固い覆い
PWN:shield.n.01	防御の構造物あるいは装置
PWN:shield.n.02	手で持ち運ぶ装甲で、打撃を遮断するためのもの
PWN:shine.v.02	発光する
PWN:ship.n.01	乗客や荷物を運ぶ船
PWN:shirt.n.01	体の上半分に着る衣服
PWN:shoe.n.01	履き物で、（足首から下の）足に適合するように整形され、皮またはプラスチックの柔軟な甲と、重みのある材料でできた底とかかとが付いている
PWN:shoot.v.01	武器からのミサイルで打つ
PWN:shoot.v.05	突然、激しく、勢いよく前方へ送る
PWN:shop.n.01	商品またはサービスの小売販売のための商業の施設
PWN:shop.n.01	商品またはサービスの小売販売のための商業の施設
PWN:shore.n.01	水際に沿った陸地
PWN:shore.n.01	水際に沿った陸地
PWN:short_pants.n.01	膝丈のズボン
PWN:short.a.01	主に一時的な感覚
PWN:short.a.02	短い、または長さに欠ける
PWN:short.a.03	身長が低い
PWN:shoulder.n.01	首と上腕の間の身体部分
PWN:shout.v.02	突然、大きい泣き声を発する
PWN:shovel.n.01	ばらばらの物質を持ち上げるための手工具
PWN:shower.n.01	水をまき散らすために配管され取り付られた具
PWN:shriek.v.01	かん高い叫び声をあげる
PWN:shrink.v.03	サイズを縮小する
PWN:shrivel.v.01	湿気の損失と同時にしぼむ
PWN:shrub.n.01	いくつかの主要茎を持つ低い木本多年生植物
PWN:shudder.v.02	恐れまたは興奮から、発作的に震える
PWN:shut.a.01	開いていないさま
PWN:sibling.n.01	兄弟や姉妹
PWN:side.n.01	ある範囲で中心あるいは基準の位置と相対する場所
PWN:sift.v.02	きめの粗い要素を外に取り分けるために、ふるいまたは他の裏ごしされる装置を通過することにより、分ける
PWN:sign.n.01	即座に明らかにならないものの知覚できる手がかり（何かが起きたはっきりと見える手がかりとして）
PWN:sign.n.02	メッセージの公の表示
PWN:silence.n.01	静かな状況（例えば、話し声がしない状況）
PWN:silent.s.01	音の欠如で、マークされます
PWN:silicon.n.01	4価の非金属元素
PWN:silk.n.01	ある種の昆虫の繭の細い糸から作られる織物
PWN:silver.n.01	金属の最も高い電気と熱の伝導率がある柔らかく白い貴重な一価金属元素でも
PWN:similar.a.01	一致または類似を特徴とする
PWN:simple.a.01	ほとんど部品を持たないさま
PWN:simuliidae.n.01	ブユ類・チョウバエ類
PWN:sin.n.01	神からの離反
PWN:sing.v.02	声で音を作り出す
PWN:sink.n.01	壁または床に取り付けられて、排水管を備えている水鉢からなる衛生器具
PWN:sink.v.01	低い場所、または高さかがむ、あるいは落ちる
PWN:sister.n.01	もう一人と同じ両親を持つ女性
PWN:sit_down.v.01	腰掛ける
PWN:sit_down.v.01	腰掛ける
PWN:sit.v.01	座った状態でいる
PWN:six.s.01	6つのアイテムまたは単位から成る量を意味するさま
PWN:sixty.s.01	50よりも10多い
PWN:size.n.01	何かの物理的大きさ（どれほど大きいか）
PWN:skate.v.01	スケート靴で先に進む
PWN:skeletal_system.n.01	動物の身体の枠組みを提供する堅い構造物（骨と軟骨）
PWN:ski.n.01	雪の上に滑るためにペアで使用される狭い木製、鉄製またはプラスチックセの滑る道具
PWN:skid.v.04	斜めに、または横に動く、通常、コントロールされない状態で
PWN:skilled.a.01	特殊技能を持つ、示す、または、必要とする
PWN:skin.v.04	皮を取り去る
PWN:skirt.n.02	ウエストからさがっている衣服
PWN:skull.n.01	脊椎動物の頭の骨格
PWN:skunk.n.04	驚かされると、ひどい悪臭を放つ流体を通常放出するアメリカの黄褐色の哺乳動物
PWN:sky.n.01	地球から見られる大気と宇宙
PWN:slab.n.01	何かの厚切りの塊り
PWN:slap.n.01	平らな物体（平手のような）による打撃
PWN:slash.v.01	徹底的なストロークで切断する
PWN:slave.n.01	人の所有物になっている人
PWN:slave.n.01	人の所有物になっている人
PWN:sled.n.01	競争者を乗せ、馬や犬によって引かれる乗り物
PWN:sleep_together.v.01	性交渉をもつ
PWN:sleep.n.01	休息中に人間の意識が途切れる、自然で周期的な状態
PWN:sleep.v.01	眠っている
PWN:sleeve.n.01	アームホールで取り付けられ腕を覆う衣服の部分
PWN:slice.n.05	物体から切り取られた薄く平たい部分
PWN:sling.n.04	発射体が回転して放出される輪になった紐で成る簡単な武器
PWN:slipper.n.01	簡単にはいて脱ぐことのできる低い靴
PWN:slippery.a.01	すべるか、滑らせるものを引き起こすか、引き起こす傾向があるさま
PWN:slit.v.02	切り口をつける
PWN:slope.n.01	隆起した地形
PWN:slovak.n.01	スロバキアの出身者、または、居住者
PWN:slowly.r.01	速度なしで
PWN:small.a.01	数、量、大きさまたは範囲が制限された、あるいは平均以下の
PWN:smell.n.01	鼻の嗅覚器が、気体の特定の化学物質によって刺激されることで起こる感覚
PWN:smell.v.01	匂いを吸いこむ
PWN:smell.v.02	香りを放つ
PWN:smile.v.01	しばしば喜びを示すために、唇を広げて表情を変える
PWN:smoke.n.01	気体中に浮遊している細かい微粒子の大群
PWN:smoke.n.02	燃焼によって作られる炭素の微粒子を含む熱蒸気
PWN:smoke.v.01	たばこ、葉巻、パイプから煙を吸い込み吐き出す
PWN:smooth.a.01	粗さ、隆起、うねまたは不連続性のない表面を持つ
PWN:snail.n.01	たいてい外側に封入する渦巻き状の貝殻を持つ、淡水または海洋性・地上性腹足類の軟体動物
PWN:snake.n.01	手足のない鱗状の細長い爬虫類
PWN:snap.v.03	緊張下にあるように突然、不意に壊れる
PWN:sneeze.v.01	刺激物が鼻に入った時のように、発作的に息を吐き出す
PWN:sniff.v.01	鼻を通して吸い込むことによって、知覚する
PWN:snog.v.01	愛情表現、挨拶などとして（だれかの口か身体の部分に）唇で触れるか、唇を押しつける
PWN:snore.v.01	睡眠中にうるさく呼吸する
PWN:snot.n.02	鼻汁
PWN:snow.n.01	氷晶という形で雲から落下する降水
PWN:snowman.n.01	押し固めた雪でつくった人形
PWN:snowshoe.n.01	深い雪の上で歩くのを助ける装置
PWN:snuff_out.v.02	火事、炎または明りのように、消す
PWN:soap.n.01	野菜の塩や動物性脂肪から作られる洗浄剤
PWN:soccer.n.01	11人の選手2チームがキックやヘッドでボールを相手ゴールに入れるフットボールの試合
PWN:sock.n.01	脚を覆う布でなる靴下
PWN:sodium.n.01	アルカリ金属グループの銀の柔らかいすべすべの金属元素
PWN:sofa.n.01	二人以上の人のための布張りをした席
PWN:soft.a.01	圧力または重さに容易に屈する
PWN:soil.n.02	腐植土や分解した岩石から成る地表の一部
PWN:soldier.n.01	軍に勤める男性または女性の下士官兵
PWN:soldier.n.01	軍に勤める男性または女性の下士官兵
PWN:solid.n.01	室温と室圧の元で固体の状態である物質
PWN:solid.s.01	良い相当な品質によって特徴づけられる
PWN:solid.s.05	空間が連続的な
PWN:solution.n.01	2つ以上の物質の均一混合物
PWN:solution.n.03	問題を解決するための方法
PWN:some.a.01	数量詞
PWN:sometimes.r.01	特定の機会、あるいは特定の場合においてしかし、常にではない
PWN:son.n.01	人間の男の子
PWN:song.n.01	歌詞のある短い音楽作品
PWN:songbird.n.01	音楽的鳴声を持つ鳥
PWN:soon.r.01	近い将来に
PWN:sorcerer.n.01	魔術や妖術を使う人
PWN:sore.n.01	皮膚の傷口の感染症
PWN:sorghum.n.01	経済的に重要な旧世界の熱帯の穀草
PWN:sorghum.n.01	経済的に重要な旧世界の熱帯の穀草
PWN:soul.n.01	人の非肉体的部分
PWN:sound.n.01	ある原因によって生み出された特定の聴覚的効果
PWN:sound.v.02	特定の雑音または音を立てる
PWN:soup.n.01	固形食物を入れた肉、魚、または野菜の煮出し汁からなる液状の食物
PWN:sour.a.02	鋭く刺すような味がするさま
PWN:sour.s.01	発酵または腐敗のにおいがする
PWN:souse.v.03	酔っぱらう、または過度に飲む
PWN:south.n.03	180度を指す基本的な羅針盤方位
PWN:sow.n.01	大人の雌豚
PWN:sow.v.01	将来の生長のために（種子を）地面の中か上に置く
PWN:soy_sauce.n.01	大豆を発酵させた薄いソース
PWN:soy.n.04	知られている最も高くタンパク性の野菜
PWN:space.n.01	すべての物が位置づけられる無限の広がり
PWN:space.n.02	（通常、ものとものの間を何らかの手段で境界づけている）空の場所
PWN:spade.n.02	足で土の中に押し込める丈夫なハンドシャベル
PWN:spain.n.01	ヨーロッパ南西部のイベリア半島に面した議会制君主国
PWN:spark.n.06	燃えているもの、または、衝突によって発せられる燃えている物質のかけら
PWN:speak.v.03	言葉を使用する
PWN:spear.n.01	用具か武器として使用される長い先の尖った棒
PWN:species.n.01	異種交配できる分類群
PWN:specific.a.01	何か特別な、特殊なまたは固有の物によって特徴づけられるまたはそれらに関連させる
PWN:spectacles.n.01	弱い視力を矯正するための一組のレンズ
PWN:spectacles.n.01	弱い視力を矯正するための一組のレンズ
PWN:speculate.v.01	特に不確かであるか仮の根拠で信じる
PWN:speed.n.01	単位時間当たりの移動距離
PWN:spell.v.01	口頭で文字を暗唱する、またはスペリングを伝える
PWN:sphere.n.06	表面上の点が中心からすべて等距離にある3次元の閉じた面
PWN:spider_web.n.02	餌になる昆虫を捕らえるためにクモが編む網
PWN:spider.n.01	8本の脚、2本の毒牙、および2本の触角を持ち、通常は体の後部に糸を吐き出す2つの器官がある捕食性のクモ形類動物
PWN:spike.n.09	長く薄い鋭いとがっている道具（森または金属）
PWN:spill.v.01	容器から（液体が）流れるように仕向けるかそのようする
PWN:spin.v.06	天然繊維を糸にする
PWN:spinach.n.01	多肉多汁で食用の濃い緑色の葉のために広く栽培される南西アジアの植物
PWN:spinal_column.n.01	骨格の軸を形成し、脊髄を保護する一連の椎骨
PWN:spindle.n.04	紡績で糸を縒るのに使われる棒または針
PWN:spiral.n.01	中心点からの距離が常に増大するように回る点の軌跡となる平面曲線
PWN:spirit.n.01	生物の中の生命力や生気を与える力
PWN:spirit.n.04	実体のない超自然の存在だが、人間に姿を見せる（あるいは声を聞かせる）ことができるもの
PWN:spit.v.01	（唾液、痰、または、唾を）吐き出す、または口から放出する
PWN:spleen.n.01	胃と横隔膜の間の身体の左側にある、大きな暗赤色の卵形の器官
PWN:spoil.v.02	消費または使用には不適当になる
PWN:sponge.n.01	様々な海洋動物の内部骨格を形成し、水を吸い込む多孔性の組み合わせの繊維また穴のあいたゴムまたは同様に使用されるセルローズ
PWN:spoon.n.01	浅い椀形の容器と柄をもったカトラリーの1つ
PWN:sport.n.01	身体運動と競い合いを要づる活動的な娯楽
PWN:spouse.n.01	結婚における人のパートナー
PWN:spread.v.10	層の表面で分布する
PWN:spring.n.01	成長の季節
PWN:spring.n.02	押されたり引っ張られたり圧し縮められたときに元の形や場所に戻る金属製の装置
PWN:spring.n.03	地下水の自然な流れ
PWN:sprinkle.v.02	（液体を）特に力で跳ね掛けるようにする
PWN:sprout.n.01	新しい枝や蕾など植物の新しく成長したもの
PWN:spur.n.04	乗り手の踵に固定され、前へ馬を駆りたてるのに用いられる尖った突き棒
PWN:square.n.01	4つの等しい辺と4つの直角がある平面長方形
PWN:square.n.04	正方形の形に近いもの
PWN:squash.n.01	多肉質の食用に適する果実のために栽培されるカボチャ属の多数の一年生の巻きひげがある匍匐性植物の総称
PWN:squash.n.02	食用カボチャの実
PWN:squash.v.01	激しく圧縮する、自然の形または状態から
PWN:squat.v.01	踵の上に座る
PWN:squat.v.01	踵の上に座る
PWN:squeeze.v.02	しっかり押す
PWN:squirrel.n.01	長い毛のふさふさした尾を持つ一種の木登り齧歯動物
PWN:stack.n.01	整然と積まれた物の山
PWN:stadium.n.01	野外で行うスポーツや催し物のための大きな建造物
PWN:stairs.n.01	一続きの階段、または一続きのステップ
PWN:stall.n.01	1匹の動物がつながれて餌を与えられる厩舎の区画
PWN:stallion.n.01	去勢してない成長した雄馬
PWN:stand.v.01	立っている
PWN:staple.n.04	ケーブルを固定するための短いU字型のワイヤー
PWN:star.n.03	夜、地球から（光の点として）見られる天体
PWN:starship.n.01	乗組員を惑星間空間（特にSFで）に運び込むように設計された宇宙船
PWN:starve.v.01	空腹の
PWN:starve.v.02	食物の不足で死ぬ
PWN:state.n.01	国家の中で、議会選出権を持った行政上の区域
PWN:state.n.04	単一の政府の下に政治的に組織された人々の集まり
PWN:state.v.01	言葉で表現する
PWN:statue.n.01	人間や動物を表した彫刻
PWN:stay.v.04	場所、位置、または状況が続く
PWN:steal.v.01	持ち主の同意なしに取る
PWN:steam.n.01	沸騰の温度の水は大気で拡散した
PWN:steel.n.01	少量の炭素のある鉄の合金
PWN:steelyard.n.01	同じ長さでない棒のある旋回できる板からなる携帯用のはかり
PWN:step.v.01	一歩移動する、または進む
PWN:stepchild.n.01	配偶者の連れ子
PWN:stepdaughter.n.01	配偶者の連れ子である娘
PWN:stepfather.n.01	母の再婚による夫
PWN:stepmother.n.01	父の再婚による妻
PWN:stepson.n.01	前の結婚によるあなたの配偶者の息子
PWN:stick.n.01	長い木材でできた道具
PWN:still.r.01	行動または状態に関して
PWN:sting.v.02	に針を通す
PWN:stingray.n.01	重傷を負わせることができる薄いむち状の尾の根元近くに大きなとげのある背骨を持つ、大型の有毒エイ
PWN:stingy.a.01	費やすのに気が進まない
PWN:stink.v.01	品質あるいはその人の性能が極めて悪い
PWN:stir.v.01	その中で道具を動かす
PWN:stock_exchange.n.01	プロの株式仲買人によって有価証券の取引が行われる取引所
PWN:stock.n.01	保有者に所有金利を得る権利を与える株式の発行を通して会社によって調達される資金（株式）
PWN:stocking.n.01	足と脚部を覆うぴったりフィットする靴下
PWN:stomach.n.01	消化管の拡大し筋肉質の嚢状の器官
PWN:stone.n.02	特定の目的のために一定の形に切り出した石
PWN:stool.v.04	便通がある
PWN:stop.v.01	停止して、動くのを止める
PWN:store.n.02	将来の使用のために可能な何かの供給
PWN:storehouse.n.01	商品の貯蔵所
PWN:storm.n.01	約64から72ノットの風（ビューフォート風力階級では11）、雨、雷、稲妻を伴った激しい天候状態
PWN:stove.n.01	調理のために使われる台所設備
PWN:straight_pin.n.01	とがっている端のワイヤのある短い真っ直ぐで堅い部分からなるピン
PWN:straight.a.02	偏差を持っていない
PWN:straight.a.08	曲線または角度がない
PWN:strange.a.01	明らかに並外れていて予想外であるさま
PWN:stranger.n.02	面識のない人
PWN:strap.n.01	物を一つにまとめたり、適所に保持したりするための細長い革の紐（または、革に似た材質の紐）
PWN:straw.n.01	たとえば籠と帽子を作ったり、まぐさとして使用されたりする植物繊維
PWN:stream.n.01	地表あるいは地下を流れる自然の流水
PWN:street.n.01	ビルが立ち並ぶ往来（通常、歩道を含む）
PWN:strength.n.01	肉体的、または精神的に強い特性
PWN:stress.v.01	強調するために、重要であるとして選び出す
PWN:stretch.v.04	広げられて、引っ張られることによりより長くなる
PWN:strike.n.01	低賃金や労働条件の悪さに抗議して作業員が集団で労働を拒否すること
PWN:strike.v.01	手、拳または武器などで、素早い一撃を加える
PWN:strike.v.01	手、拳または武器などで、素早い一撃を加える
PWN:strike.v.01	手、拳または武器などで、素早い一撃を加える
PWN:string.n.01	軽いひも
PWN:stripe.n.05	背景と異なる色や織地の、幅の狭い印
PWN:stroke.n.01	クラブ、ラケット、バット、キューまたは手でボールをスウィングする、または打つ行為
PWN:stroke.n.10	ペン、鉛筆、または絵筆で表面にマークをつけること
PWN:strong.a.01	強さまたは力を平均より大きいか期待されたようにしておくさま
PWN:strontium.n.01	アルカリ金属グループの柔らかく銀または白、または黄色っぽい金属元素
PWN:student.n.01	教育機関に登録されている学習者
PWN:study.n.02	ある問題を（特に読書によって）学び理解するために頭を使うこと
PWN:study.v.05	本を読むことにより学習する
PWN:stump.n.01	伐り倒された後に残っている木の根本の部分
PWN:stupid.a.01	知的な鋭敏さを欠いている、または知的な鋭敏さの欠如で特徴づけられる
PWN:sty.n.02	豚の囲い
PWN:stylus.n.01	レコードプレーヤーのカートリッジについた鋭くとがった装置
PWN:stylus.n.02	筆記、線画、彫刻に使う先のとがった道具
PWN:submerge.v.02	完全に覆うか、感知できなくする
PWN:submission.n.01	他のもの（コンペとして）を判断するために提出された物（原稿、設計図、すべてのジャンルの作品のモデルまたは見積もりなど）
PWN:subsequently.r.01	言及時の後に起こること
PWN:subsequently.r.01	言及時の後に起こること
PWN:substance.n.01	人やもので構成される、実在する物理的な物質
PWN:substitute.n.01	別のもの代わりをするか、代わりをすることができる人、または物
PWN:subtract.v.01	引き算をする
PWN:succeed.v.01	成功を収めるか、または望んでいる目標に達する
PWN:suck.v.01	口の中を実質的に真空にすることで、口に吸い込む
PWN:sudden.a.01	何の前触れもなく、または短い時間に起こるさま
PWN:suddenly.r.01	思いがけなく起こること
PWN:sugar_beet.n.02	砂糖の原料として栽培する白い根のビート
PWN:sugar.n.01	甘味料・保存剤として使う白い結晶状の炭水化物
PWN:sugarcane.n.01	樹液が糖蜜と商業的な糖の源である多汁のトウ
PWN:suit.n.01	すべてが同じ繊維と色の外着のための1セットの衣類（通常ジャケットとズボンまたはスカート）
PWN:suitable.s.01	出来事または使用が意味される、または構成される
PWN:sulfur.n.01	豊富な無粋で無臭な多価非金属元素
PWN:sum.n.02	一群の数の加算によって得られる量
PWN:sum.n.05	全体量
PWN:summer.n.01	1年で最も温暖な季節
PWN:sun.n.01	太陽系の惑星のためのそして熱光源である星
PWN:sunday.n.01	1週間の最初の日
PWN:sunflower.n.01	暗い円盤状小筒花と目立つ黄色の放射花がある大きな頭状花があるヒマワリ属の植物のいずれか
PWN:supper.n.01	夕方の軽い食事
PWN:supply.v.01	何かを役に立つまたは必要であるものにする
PWN:support.n.07	上にある物を支えたり、土台となる物
PWN:support.v.01	精神的あるいは心理的な支援、援助、または勇気を与える
PWN:surface.n.01	物体の外側の境界、または境界となるあるいはそれに似た物質の層
PWN:surprise.v.01	驚くべき原因
PWN:surrender.v.01	権力または他の者の所有物をあきらめまたは手放すことに同意する
PWN:surrogate.n.01	誰かの代わりを務める人
PWN:surviving.s.01	まだ存在している
PWN:suspect.v.01	本当であるか、真実であるか、可能性があるか、想像する
PWN:swallow.v.01	飲食することの一部として、食道を通過する
PWN:swamp.n.01	季節的に水につかる低地
PWN:swan.n.01	非常に長い首と成長するとたいてい白い羽毛を持つ堂々とした重い体の水鳥
PWN:swear.v.03	まじめに約束を守る
PWN:sweat.v.01	皮膚の気孔を通して汗を排出する
PWN:sweep.v.06	掃いて掃除する
PWN:sweet_potato.n.02	食用芋づるの塊根で、米国の暖かい地域で広く栽培される
PWN:sweet.a.01	砂糖の特有の味を持つこと、または示すさま
PWN:sweet.n.03	砂糖がいっぱいの食物
PWN:swell.v.01	サイズ、大きさ、数、または強さが増える
PWN:swelling.n.01	異常な隆起もしくは部分的肥大
PWN:swim.v.01	水を通して移動する
PWN:swing_around.v.01	物理的または比喩的に、突然転換し、他方に向く
PWN:swing.v.01	通常打撃を与えるために曲線または弧を描いて動かす
PWN:swing.v.05	大きく弧を描く身振りや動きをする
PWN:sword.n.01	切りつけ、または突き刺し用の武器で、長い金属刃と手を保護する柄がついている
PWN:syllable.n.01	音素より大きな話し言葉の単位
PWN:symbol.n.01	慣習的な意味を獲得した任意の（書かれたまたは印刷された）記号
PWN:syringe.n.01	液体の注入あるいは抜き取りに使われる医療器具
PWN:syrupy.s.02	流れに対する比較的高い抵抗を持つさま
PWN:system.n.01	論理的実体として働くように設計された、相互に関係する、相互に作用する人工物を統合した道具
PWN:table.n.02	1本以上の垂直な脚に支えられ、上部が平らでなめらかな家具
PWN:tail.n.01	特に、胴体または体の中心を超えたところまで延び、広がっているの脊椎動物の体の後部分
PWN:tailor.n.01	衣服を仕立てたり、直したりする仕事の人
PWN:take_off.v.06	衣服をとる
PWN:take.v.04	物理的に取る、人の手に入れる
PWN:talk.v.01	考えを言い合う
PWN:talk.v.02	スピーチで表す
PWN:tall.a.01	大きな垂直の寸法
PWN:tall.a.01	大きな垂直の寸法
PWN:tamale.n.02	トウモロコシ・ひき割りトウモロコシの練り粉に肉の混ぜ物を詰め、トウモロコシの皮で包んで蒸したもの
PWN:tambourine.n.01	側面に金属製の円盤がついた、片側に皮を張った浅い太鼓
PWN:tamias.n.01	北米東部産のシマリス
PWN:tan.v.01	皮と獣皮をタンニン酸で当てて、それらを革に変える
PWN:tank.n.01	囲まれた装甲軍の軍用車両
PWN:tantalum.n.01	堅くて光沢のある灰色の金属元素で、高い耐腐食性がある
PWN:taoism.n.01	老子の教えに従うことを主張し、汎神論と妖術をも取り込んだ中国の道教の分派
PWN:taoist.n.01	道教の宗派の信者
PWN:tape.n.01	縛るためまたは固定するために使用する細長い布または紙
PWN:tapered.s.01	次第に狭くなるさま
PWN:tapir.n.01	熱帯アメリカ・東南アジア産の大きな体に肉質の鼻口部を持つ害にならない主に夜行性の大型有蹄動物
PWN:taro.n.02	太平洋の諸島の草本で、食用になる根を目的に熱帯地域全域で、またその大きな光沢のある葉から観賞用に温帯地域で、栽培される
PWN:taste.n.01	舌とのどの味蕾が可溶性刺激物の化学成分に関する情報を伝達する際に起こる感覚
PWN:taste.v.01	味がある
PWN:taste.v.02	味の感覚によって知覚する
PWN:tasty.a.01	味覚が良い
PWN:tattoo.n.02	入れ墨によって皮膚に作られる模様
PWN:taut.s.01	きつく引かれるまたは引っ張られる
PWN:taut.s.01	きつく引かれるまたは引っ張られる
PWN:tax.n.01	政府の財源のために市民自体・財産・活動に対して課されて徴収される金銭
PWN:tea.n.01	茶の葉を水に浸すことによって作られる飲料
PWN:teach.v.01	技能か知識を分け与える
PWN:teacher.n.01	教職の人
PWN:team.n.01	（特にスポーツにおける）協調的な一団
PWN:tear.n.01	涙腺により分泌される澄んだ塩気のある塩分を含んだ溶液の一滴
PWN:tear.v.01	分離または突然分離する
PWN:technetium.n.01	自然で見つからない結晶質の金属元素
PWN:technology.n.01	商業または産業に対する科学の実用化
PWN:telephone.n.01	長い距離を転送されることができる音を電子信号に変換し、その後受信信号を音に再度変換する電子機器
PWN:telescope.n.01	遠距離にある物の像を拡大する装置
PWN:television_program.n.01	テレビで放送される番組
PWN:television_receiver.n.01	テレビ信号を受信してスクリーンに映す電子機器
PWN:television.n.01	静止しているものまたは動いているものの視覚イメージを放送するもの
PWN:tell.v.03	物語る、または、詳細に報告する
PWN:tellurium.n.01	セレンと硫黄に関連があるもろい銀白色のメタロイドの要素
PWN:temper.n.02	感情の特徴的な状態（常習的または比較的一時的な）
PWN:temperature.n.01	（分子活動に対応した）物体や環境の熱さや冷たさの度合い
PWN:temple.n.01	神聖な礼拝のための建築物からなる崇拝の場所
PWN:temple.n.02	額の両側の平坦な部分
PWN:tempt.v.01	したいと思わせる、心を向けさせる、あるいは誘惑する
PWN:ten.s.01	9よりも1多い
PWN:tendency.n.04	何かが動く傾向の一般的方向
PWN:tendon.n.01	筋肉と骨を結びつける弾力性のない組織の索または帯
PWN:tennis.n.01	2人または4人のプレーヤーが行なう競技で、コートを分けるネット越しにボールを打って往復させるもの
PWN:tent.n.01	携帯用の住居（通常帆布製で支柱の上に広げロープと杭で地面に固定する）
PWN:terbium.n.01	希土類の金属元素
PWN:termite.n.01	木を主食にする白色の軟体のアリのような社会性の昆虫
PWN:test.n.05	何かをテストする行為
PWN:test.v.01	品質のための試験を行うまたは実験的使用を試みる
PWN:testis.n.01	男性の2つの生殖腺
PWN:tether.v.01	ロープで結ぶ
PWN:thallium.n.01	スズに似ているが、空気に触れると変色する、軟質で灰色の可鍛性の金属元素
PWN:thank.v.01	感謝の意を表す、または謝意を示す
PWN:thatch.n.02	屋根をふくために用いられる植物の茎
PWN:theater.n.01	演劇や映画が上演される建物
PWN:then.r.0	その時
PWN:then.r.01	その後、または、間もなく
PWN:then.r.03	その時
PWN:theory.n.01	自然界のある側面の十分な裏付けがある説明
PWN:there.r.01	その場所で
PWN:there.r.03	その場所に、または、それの方へ
PWN:thermometer.n.01	温度を測るための計測器
PWN:thick.a.01	薄くない
PWN:thick.a.03	一貫性があり比較的濃い
PWN:thickness.n.01	物体の長さまたは幅とは違う、物体を貫通した寸法
PWN:thief.n.01	それを維持する、またはそれを販売するという意図で他の誰かのもの資産を奪う犯罪者
PWN:thief.n.01	それを維持する、またはそれを販売するという意図で他の誰かのもの資産を奪う犯罪者
PWN:thigh.n.01	尻と膝の間の脚の部分
PWN:thin.a.01	ひとつの面から反対の面間でまたは断面において比較的小さな程度の
PWN:thin.a.01	ひとつの面から反対の面間でまたは断面において比較的小さな程度の
PWN:thin.a.02	余分な肉がないさま
PWN:thing.n.09	それ自身の存在を持つと考えられる特質または品質のいずれか
PWN:thing.n.12	別々のまた自己充足的な実体
PWN:think.v.02	期待する、信じるまたは　看做す
PWN:think.v.03	推論、決定をするためまたは、結論や判断に達するために心、あるいは理性を使うまたはを発揮する
PWN:think.v.03	推論、決定をするためまたは、結論や判断に達するために心、あるいは理性を使うまたはを発揮する
PWN:think.v.11	心に持つ、あるいは形成する
PWN:thinking.n.01	慎重に何かを考慮するというあなたの頭を使う過程
PWN:third.s.01	2番目の直後で、4番目の直前の位置に来るさま
PWN:thirst.v.01	飲む必要性があると感じる
PWN:thirty.s.01	20よりも10多い
PWN:thorax.n.02	人体の首と横隔膜の間の部分、または他の脊椎動物のそれに相当する部分
PWN:thorium.n.01	柔らかで銀白色の4価の放射性金属元素
PWN:thousand.s.01	1,000のアイテムまたは単位からなる量を意味しているさま
PWN:thrash.v.06	穀物から種をたたきだす
PWN:thread.n.01	裁縫や編み物に使われる撚った繊維（綿、絹、毛、ナイロンなど）の細いひも
PWN:threaten.v.02	に対して損傷または処罰の意図を発するために：
PWN:three.s.01	2よりも1多い
PWN:threshing_floor.n.01	穀物を叩いたり踏んだりして脱穀するための床あるいは地面のスペース
PWN:thrice.r.01	3回
PWN:throat.n.01	胃と肺への経路
PWN:through.r.01	始めから終わりまで
PWN:through.r.01	始めから終わりまで
PWN:throw.v.01	空気中で推進する
PWN:thrust.v.01	力強く押す
PWN:thulium.n.01	柔らかで銀色の希土類金属元素
PWN:thumb.n.01	前肢の太く短い最も内側の指
PWN:thump.v.03	手、拳または若干の重い器具でひどく打たれる
PWN:thunder.n.02	稲妻の電光の道に沿って大気が広がって生じるうなるようなすさまじい大音響
PWN:thunder.v.03	雷が聞こえている例である
PWN:thunderbolt.n.01	雷に伴う稲光の放電
PWN:thursday.n.01	週の5番目の日
PWN:thus.r.02	示された方法で
PWN:tick.n.02	とげのある吻を持つ小さな寄生的なクモ類の2つの科のどれか
PWN:ticket.n.01	保有者が何らかの（公共輸送機関に乗るか、一般向けの娯楽｛ごらくのような）権利があることを示している商業的な文書
PWN:tide.n.01	月の引力による海面の周期的な上がり下がり
PWN:tidy.v.01	（ものか場所）を整理する
PWN:tie.n.03	競技で得点が同じであること
PWN:tie.v.01	ロープ、ひも、あるいはコードで固定する、または確保する
PWN:tiger.n.02	黒いストライプのある黄褐色の毛のアジア大部分の森に生息する大きなネコ科の動物
PWN:tile.n.01	薄くて平らな長方形の（焼成粘土、ゴムまたはリノリウムなどの）板で、表面を覆うために使用される
PWN:till.v.01	耕作の準備をするために、鋤いて砕土し、肥料をやるなどして土地を耕す
PWN:time_interval.n.01	2つの瞬間によって区切られる一定の時間
PWN:time_period.n.01	時間の量
PWN:time.n.01	何かの出来事のための場合や1つの機会
PWN:time.n.05	物事がその中で未来から現在を通り過去へと流れる、経験の連続体
PWN:timely.s.01	制限時間が終了する前に
PWN:tin_plate.n.01	錆を防ぐためにスズめっきされた鉄あるいは鋼鉄の薄い板
PWN:tin_plate.n.01	錆を防ぐためにスズめっきされた鉄あるいは鋼鉄の薄い板
PWN:tin.n.01	銀色で可鍛性のある金属元素で、腐食耐性がある
PWN:tinkle.v.01	高い音をたてるか、発する
PWN:tip.n.01	あるものの一番先
PWN:tire.v.02	酷使、あるいは極度の緊張、ストレスを通じてひどく疲れさせるあるいは疲れさせる
PWN:tired.a.01	力またはエネルギーを消耗した
PWN:tired.a.01	力またはエネルギーを消耗した
PWN:titanium.n.01	強い軽量合金に使用される、軽くて強い灰色の光沢がある耐食性金属元素（飛行機の部品のような）
PWN:tobacco.n.01	吸い込んだり摂取したりするために乾燥させて加工されたタバコの葉
PWN:today.r.02	昨日または明日とは区別されるこの日に
PWN:toe.n.01	足の指の1つ
PWN:together.r.01	互いと接して、または近くで
PWN:toilet.n.01	一つ以上のトイレを備えている部屋または建築
PWN:token.n.02	何か他の物の印となるもの
PWN:tomato.n.01	赤や黄の果肉質のややすっぱい野菜
PWN:tomorrow.r.01	現在の日に続く次の日、翌日
PWN:tone.n.07	上音のない、一定の音
PWN:tongs.n.01	物をつかむ様々な装置のいずれか
PWN:tongue.n.01	粘膜で覆われ、口腔に位置する筋肉組織の移動可能な塊
PWN:tool.n.01	仕事の慣例で使われる道具
PWN:tooth.n.01	脊椎動物の顎にある硬い骨のような構造物
PWN:top.n.01	あるものの上の部分
PWN:torch.n.01	手で持つ灯り
PWN:torment.v.01	感情的または精神的に苦しめる
PWN:tornado.n.01	地上へ向かって伸びた漏斗雲が特色で、地上に発生する局地的で激しく破壊的な暴風
PWN:tortilla.n.01	トウモロコシ粉か小麦粉から作られた薄いパン種を入れてないパンケーキ
PWN:torus.n.01	円と交差しない軸の周りで円を回転させるとできる環状の表面
PWN:toucan.n.01	非常に大きな薄い壁のくちばしを持つ鮮やかな色の樹上性で果実を食べる熱帯アメリカ産の鳥
PWN:touch.v.01	と身体的に接触する、と接触する
PWN:tournament.n.01	競技者が勝者を決定するため一連の試合を行うスポーツ競争
PWN:towel.n.01	乾燥や拭きとり用の長方形の吸収性の布（または、紙）
PWN:tower.n.01	直径より高い構造物
PWN:town.n.01	決まった境界がある都市区域で、市よりも小さい
PWN:trail.n.01	物が通った跡あるいは残した痕跡
PWN:train.n.01	結合され機関車で引かれる一連の鉄道車両によって提供される公共輸送機関
PWN:transgress.v.01	法、規則、契約、または約束を無視して、行動する
PWN:translate.v.01	ある言語から他の言語へ（言葉を）言い換える
PWN:transport.v.02	車両で、人手で、または、身に付けて、維持している間に移動する
PWN:trap.n.01	何か（通常動物）を捕らえて閉じこめる装置
PWN:trap.v.02	捕らえる、あるいは罠のようなものに
PWN:travel_by.v.01	そこを通り過ぎて動く
PWN:travel.v.01	場所を変える
PWN:travel.v.02	旅または旅行を経験する
PWN:traveler.n.01	場所を変える人
PWN:tray.n.01	品物または食物を固定し、展示または供するための開いた器
PWN:tree.n.01	中心的な幹と枝が明確な持ち上がった樹冠を形成する背が高い多年生の木本
PWN:trial.n.04	正当な法手続きによって、ある人間が無罪か有罪かを決めること
PWN:triangle.n.01	3つの辺をもつ多角形
PWN:tribe.n.01	（通常は文字使用以前の）人々の社会的区分
PWN:trick.n.01	ずる賢い、または人をだます行動、または計略
PWN:trouble.n.01	困難のもと
PWN:trouser.n.01	ウエストからひざまたは足首まで伸びていて、別にそれぞれの足首を覆っている衣服
PWN:truck.n.01	物を運ぶのに適した自動車
PWN:true.a.01	事実か現実と一致している
PWN:trunk.n.01	木の主茎
PWN:trust.v.01	信用、または信頼する
PWN:truth.n.01	証明された事実
PWN:try.v.01	努力する、または試みる
PWN:tube.n.01	物、液体または気体を保持して誘導するのに使用される、長い空洞のある（通常筒状である）物で成る導管
PWN:tuesday.n.01	1週間の3番目の日
PWN:tug.v.01	強く引く
PWN:tumble.v.01	まるで崩れるように、落ちる
PWN:tungsten.n.01	重い灰白色の金属元素
PWN:turkey.n.01	扇形の尾を持つ大型キジ科の鳥
PWN:turn.v.01	抽象的な意味でも、方角または方向を変える
PWN:turn.v.04	動き回るか、または回転させる
PWN:turnip.n.01	大きな果肉の多い食用の白または黄色の根を持つ広く栽培された植物
PWN:turtle.n.02	骨性の甲羅と泳ぐためのひれ足のような四肢を持つ様々な水生と陸生の爬虫類の総称
PWN:twelve.s.01	12品目またはユニットで成る数を示す
PWN:twenty.s.01	20のアイテムまたは単位からなる量を意味するさま
PWN:twice.r.01	2回
PWN:twin.n.01	同じ妊娠から同時に生まれた2人の子供の一方
PWN:twist.v.04	らせん状を形成する
PWN:twist.v.05	ねじれた形になる
PWN:two.s.01	1より大きい
PWN:udder.n.01	ウシ科（ウシ・ヒツジ・ヤギ）の乳腺
PWN:ugly.a.01	感覚的に不快な
PWN:umbilical_cord.n.01	胎盤と胎児を結ぶ膜状の管
PWN:umbrella.n.01	軽い手持ちの折り畳める天蓋
PWN:uncle.n.01	あなたの父または母の兄弟
PWN:uncover.v.01	可視化させる
PWN:underpants.n.01	体のウエストから太股までを覆う下着
PWN:understand.v.01	本来の姿、あるいは意味を知り、理解する
PWN:undertaking.n.01	引き受けられたまたは試みられた仕事の一部
PWN:undress.v.01	衣服を脱いだ状態になる
PWN:unfold.v.04	閉じたか包まれた状態から散開するか開く
PWN:uniform.n.01	特定のグループの構成員が所属を明確にするために着る、特有のデザインの服
PWN:unite.v.01	協力して行うか、共通の目的または信念の下に結束する
PWN:universe.n.01	存在するすべてのもの
PWN:university.n.02	研究と教育のための施設だけでなく管理局、住居区を含む高等教育の中枢が収容されている施設
PWN:untie.v.01	のネクタイを外す
PWN:ununbium.n.01	放射性超ウラン元素
PWN:ununhexium.n.01	放射性超ウラン元素
PWN:ununpentium.n.01	放射性超ウラン元素
PWN:ununquadium.n.01	放射性超ウラン元素
PWN:ununtrium.n.01	放射性の超ウラン元素
PWN:up.r.01	低いところから高いところへ空間的にまたは比喩的に
PWN:uranium.n.01	重い有毒の銀灰色の放射性金属元素
PWN:urge.v.01	示された方向を強制するか、推進する
PWN:urine.n.01	液体状の排出物
PWN:use.v.01	業務に入れられる
PWN:uterus.n.01	女性の骨盤の筋肉でできた中空器官
PWN:uvula.n.01	軟口蓋の後方の小さなペンダント状の肉でできた丸い突出部
PWN:vacate.v.01	自発的に（仕事、役職、位置）を去る
PWN:vacation.n.01	労働を離れた余暇時間で、休息または娯楽に用いられる
PWN:vacuum.n.01	物質の欠如
PWN:vagina.n.01	女性の生殖器官の下部
PWN:vainly.r.01	無駄に
PWN:valley.n.01	地表の細長いくぼみで、ふつう川になっている
PWN:value.n.01	計測されるか、割り当てられるか、計算される数の量
PWN:value.n.03	（金銭・品物・サービスの）金額的価値で、公正に見て他のものと同等価値であるもの
PWN:valve.n.01	それを通る体液の一方向だけの流れを確実する弁を持った（心臓のような）中空の器官の構造
PWN:vanadium.n.01	柔らかい銀白色で有毒の金属元素で、鋼鉄合金に用いられる
PWN:vapor.n.01	大気中の物質の細かな目に見える浮遊物
PWN:vegetable.n.01	多数の草本植物の食用の種、根、茎、葉、球根、塊茎、あるいは甘くない果実
PWN:vehicle.n.01	人や物を運ぶ乗物
PWN:vein.n.01	毛細血管から心臓へ血液を運ぶ血管
PWN:vent.n.03	溶岩とガスが噴出する地殻（あるいは他の惑星の表面）の裂け目
PWN:verdict.n.01	決定のためにそれに提出される争点の事実の陪審による調査結果
PWN:version.n.02	同じ種類のものだが、他と少し違うもの
PWN:vertical.a.01	水平軸の平面または基線に対して直角の
PWN:very.r.01	強意語として使われる
PWN:vetch.n.01	巻きひげで終わる羽状複葉と小さくてさまざまな色の花を持つソラマメ属の様々なつる性植物
PWN:victimize.v.03	偽りにより奪う
PWN:victory.n.01	戦いや競争が成功裏に終わること
PWN:village.n.01	町より小さい人々のコミュニティ
PWN:village.n.02	町よりも小さい集落
PWN:vine.n.01	表面に沿って登ったり巻きついたり這ったりして支えを得る、茎の弱い植物
PWN:vinegar.n.01	通常ワインまたはサイダーでアルコールの酸化によって生産されて、調味料または食物防腐剤として使われるすっぱい味の液体
PWN:violence.n.01	攻撃的行為（抵抗する人物に対して行うような）
PWN:violent.a.01	大きな力、エネルギーまたは激しい感情を持って行動する、あるいはそれらを特徴とする、あるいはそれらに起因するさま
PWN:violin.n.01	バイオリン系の中で最も音色の高い弦楽器
PWN:violinist.n.01	ヴァイオリンを演奏する音楽家
PWN:virtuous.a.01	道徳的に素晴らしい
PWN:virus.n.01	生きている宿主の細胞内のみでそれ自身を複製する極微の感染性の病原菌
PWN:visible.a.01	見ることができる
PWN:visit.v.07	客として滞在する
PWN:vocabulary.n.01	ある仕事で使われる単語のリスト
PWN:vocabulary.n.02	単語に関する言語ユーザーの知識
PWN:voice.n.02	声道で調節される声帯の振動によって生じる音
PWN:volcano.n.02	火山性の物質でできた山
PWN:vomit.v.01	口から胃の内容を放出する
PWN:vote.v.01	候補か測定か解決のための人の好みを表現する
PWN:vowel.n.01	声道をあけて発音する言語音
PWN:vulva.n.01	女性性器の外側の部分
PWN:wage.n.01	報いるもの
PWN:wages.n.01	立派な行動に対する報酬、または悪行に対する報い
PWN:wagon.n.01	馬やトラクターが引く各種の車輪によって動く車の総称
PWN:wagtail.n.01	歩くたびに上下にぐいと動く非常に長い尾がある旧世界の鳥
PWN:waist.n.01	肋骨とお尻の間の体のくびれ
PWN:wait.v.01	1つの場所にとどまり、何かを予想する、または期待する
PWN:wake_up.v.02	睡眠状態を止める
PWN:walk.n.01	足で移動する行為
PWN:walk.v.01	足を使って前進する
PWN:walk.v.10	散歩する
PWN:walking_stick.n.01	歩行を支えるために手に持つ棒
PWN:wall.n.01	高さと長さが厚さよりも大きい、建築上の仕切り
PWN:wall.n.06	空間を取り囲む物質の層
PWN:war.n.01	敵に対する武力紛争の行い
PWN:ware.n.01	同じ種類あるいは素材の品物
PWN:warm.a.01	心地よく快適な温度を有するか生み出す、または、熱を与えるか維持する
PWN:warm.v.02	暖かいかより暖かくする
PWN:warn.v.01	危険、潜在的害または危険を通知する
PWN:warship.n.01	戦争に利用可能な政府船
PWN:wash.v.01	何らかの化学過程で浄化する
PWN:wash.v.02	石鹸と水で（人の身体）をきれいにする
PWN:wash.v.02	石鹸と水で（人の身体）をきれいにする
PWN:wash.v.03	石鹸や水などのような洗浄剤を使って清潔にする
PWN:wasp.n.02	一般的に腹部に細長い体を細い軸で接続しいて、恐るべき針がある社会的であるか孤独な膜翅類の昆虫
PWN:waste.v.01	軽率に費やす
PWN:watch.v.01	注意を払って見る
PWN:water.n.06	大部分の動植物の生命に必要な液体
PWN:water.v.01	水路、溝または流れで、水を供給する
PWN:waterfall.n.01	川の水の急な落下
PWN:watermelon.n.02	堅い緑の皮と甘い赤か時々黄色がかったみずみずしい果肉のある大きな長方形または丸みがあるメロン
PWN:waterskin.n.01	水を入れる皮袋
PWN:wave.n.01	液体の表面を越えて動くうねの連続（特に大波を越えて）
PWN:wax.n.01	鉱物、植物、または動物から取られた物質の総称
PWN:wax.n.01	鉱物、植物、または動物から取られた物質の総称
PWN:way.n.05	行動の方針
PWN:weak.a.01	体力に欠けている
PWN:wealth.n.01	金持ちで裕福である状態
PWN:weapon.n.01	戦いまたは狩猟に使われる機材または道具
PWN:wear.v.01	身に付けている
PWN:wear.v.09	誰かの体に服を着せる
PWN:weather.n.01	温度、風、雲、および降水量の観点から、大気状態を形成する大気条件
PWN:weave.v.01	まるで機をおるかのように、織り合わせる
PWN:weave.v.02	例えばウールまたは綿のような繊維の要素を織り合わせて、一枚の布を作る
PWN:wedge.n.01	横断面での三角形の形をしたあらゆる形
PWN:wednesday.n.01	1週間の4番目の日
PWN:weed.n.01	栽培された植物を追い遣る植物
PWN:week.n.01	連続した7日間
PWN:weigh.v.01	一定の重さを持つ
PWN:weight.n.01	重力による質量によってはたらきかけられた垂直の力
PWN:well.n.01	水、油、ガスあるいは塩水を得るためにあけられた、または彫られた深穴またはシャフト
PWN:well.n.01	水、油、ガスあるいは塩水を得るためにあけられた、または彫られた深穴またはシャフト
PWN:west.n.02	270度を指す基本的な羅針盤方位
PWN:wet.a.01	水のような液体を被る、または濡れる
PWN:whale.n.02	流線型の体を持ち、頭部の噴気孔を通して呼吸するより大型のクジラ目の各種の哺乳動物
PWN:wheat.n.01	直立する穂状花序と明るい褐色の穀粒を持つ、一年生または二年生の草
PWN:wheel.n.01	円形の枠と輻（あるいは堅い円盤）からできていて軸や心棒の回りを回転する（車や他の機械にあるような）単純な機械
PWN:whetstone.n.01	刃のある道具やナイフを研ぐ平たい石
PWN:whip.n.01	むちうちに使われる柄としなやかなひもがついた道具
PWN:whirlpool.n.01	水の力強い循環する流れ（通常、潮の衝突の結果）
PWN:whisper.v.01	そっと言う
PWN:whistle.v.03	笛を鳴らして発するか、または表現する
PWN:white.a.01	最大限の明度の無彩色である
PWN:whole.a.01	例外なくすべての構成要素を含むさま
PWN:wide.a.01	左右に大きな（あるいは、特定の）範囲を持つさま
PWN:widening.n.01	幅の増加
PWN:widow.n.01	夫に死なれた女性、特に再婚しない人
PWN:widower.n.01	妻に死なれた男性で特に再婚しない人
PWN:width.n.01	端から端までの何かの範囲
PWN:wife.n.01	結婚している女性
PWN:wife.n.01	結婚している女性
PWN:wild_boar.n.01	細い体と突出した牙を持つ、ほとんどの飼い豚の先祖の旧世界産の豚
PWN:wild_boar.n.01	細い体と突出した牙を持つ、ほとんどの飼い豚の先祖の旧世界産の豚
PWN:wild.a.01	抑制または制御の極端な欠如によって特徴づけられる
PWN:wild.a.02	自然な状態で
PWN:willow.n.01	ヤナギ属の落葉性高木および低木の総称
PWN:win.v.01	コンテストまたは競争の勝者である
PWN:wind.n.01	気圧の高い地域から気圧の低い地域へ空気の流れ（時々かなりの力で）
PWN:wind.v.03	アレンジする、または巻きつける
PWN:window.n.01	壁や天井に採光や通風のために作られた、ガラスのはまった木や金属の枠組み
PWN:wine.n.01	発酵させたジュース（特にブドウ）
PWN:wing.n.01	飛ぶための可動器官（一組のうちの1つ）
PWN:winter.n.01	1年の大寒
PWN:wipe_up.v.01	モップで、あるいはモップのようなもので洗う、拭く
PWN:wipe.v.01	循環運動で擦れる
PWN:wire.n.01	金属で作られており、ものを固定するか、おりまたはフェンスその他を作るのに用いられる靭帯
PWN:wire.n.02	電気を離れたところに伝える金属製の伝導体
PWN:wise.a.01	知恵または認識によって所有している、または引き起こされる
PWN:wish.v.02	何かするのを好むか、またはしたいと願う
PWN:withdraw.v.01	引っ込む、引き下がるまたは後退する
PWN:witness.n.01	事件を目撃し、何が起こったかを知らせる人
PWN:wolf.n.01	通常群れをなして狩りをする、北米・ユーラシア産の様々な捕食性で肉食性のイヌ科の哺乳動物各種
PWN:woman.n.01	（成人男性に対するものとして）女性である大人
PWN:wood.n.01	木の皮の下にある、固い繊維質の木化した物質
PWN:woodpecker.n.01	木登り用の強い爪と固い尾を持ち、昆虫を捕るために木に穴をあけるノミのように固いくちばしを持つ鳥
PWN:wool.n.02	（羊などの）動物から刈り取られ、編物用の糸に紡がれる繊維
PWN:word.n.01	ネイティブスピーカーが同定できる言語の単位
PWN:work.n.01	何かを作ったり何かをする活動
PWN:work.v.01	目的のためにまたは必要に迫られて、精神的、物理的な行動をすることによって尽力する
PWN:worker.n.01	ある特定の職で働く人
PWN:workshop.n.01	小規模な仕事場で、そこで手工芸や製造が行われる
PWN:world.n.02	一般の人々
PWN:world.n.08	地球の全住民
PWN:worm.n.01	特に環形動物門、毛顎動物門、線形動物門、ひも形動物門、および扁形動物門の、数々の比較的小型の細長く柔らかい体をした動物
PWN:worry.v.01	胸を痛める、憂慮している、案じている、問題を抱えている、または不安である
PWN:worse.a.01	別のものよりも品質、状態あるいは望ましさで劣っている
PWN:worship.n.01	礼拝活動
PWN:worship.v.02	（神）への献身を示す
PWN:wrap.v.01	覆いまたは保護として調整するまたは包む
PWN:wrench.n.03	ナットやボルトを支持したりねじったりする手工具
PWN:wrestle.v.01	対立する風潮または勢力に打ち勝とうとする戦い
PWN:wrinkle.n.01	表面上は口先上手である軽い鬱病
PWN:wrinkled.a.01	しわを特徴とする
PWN:wrist.n.01	橈骨の末端と手根骨の最も近い列の間にある関節
PWN:write.v.02	書面で連絡する、または表す
PWN:xenon.n.01	無色、無臭の不活性気体元素で、地球の大気中に微量に存在する
PWN:yam.n.04	食物のために世界中の熱帯地方で栽培されるヤマノイモ属のさまざまなヤムイモ植物の食用の塊根
PWN:yawn.v.01	疲れているときに、または酸素の欠乏などによってあくびをする
PWN:year.n.01	365日間（または366日間）
PWN:yeast.n.01	イースト細胞を含んでいる商用のパンの発酵剤
PWN:yellow.s.01	色のスペクトルにおける、緑色とオレンジ色の間の中間色の
PWN:yesterday.r.01	今日の前に先行した日
PWN:yogurt.n.01	凝乳で作ったカスタードのような食物
PWN:yoke.n.05	両端に吊り下げたバケツを運べるように、肩に担ぐ木製の枠から成る支え
PWN:yoke.n.05	両端に吊り下げたバケツを運べるように、肩に担ぐ木製の枠から成る支え
PWN:young_buck.n.01	ティーネージャーか若い成人男子
PWN:young.a.01	（生物、特に人について使用され）生命、発達、または成長の初期の段階に
PWN:ytterbium.n.01	銀色で柔らかい金属元素
PWN:yttrium.n.01	銀色の金属元素で希土類鉱物に広く存在する
PWN:zebra.n.01	駿足で黒と白の縞模様を持つ、アフリカ産の各種の馬
PWN:zero.s.01	検討中のいずれかまたはすべてのユニットが無いことを示す
PWN:zinc.n.01	蒼白の光沢がある金属元素
PWN:zirconium.n.01	チタニウムに類似している光沢がある灰色の強固な金属元素
