id	Definition
Action:can.V	To have the ability to do something.
Agriculture:burn land.V	Clear an area with fire.
Agriculture:crops.N	The output of plants cultivated that is grown on a large scale.
Agriculture:cultivate.V	To prepare an area by tilling, planting seeds etc. in order to grow plants.
Agriculture:farm.N	Any tract of land or building used for agricultural purposes, such as for raising crops and livestock.
Agriculture:farmer.N	A person who works the land or who keeps livestock, especially on a farm.
Agriculture:grow.V	To cultivate a specific type of plant in order to harvest it.
Agriculture:harvest or harvest season.N	The crop gathered in a season and the time during which crops are typically harvested.
Agriculture:harvest.N	The crop gathered in a season.
Agriculture:herd (something).V	Keep or move animals together.
Agriculture:irrigate.V	To supply with water; to water.
Agriculture:mow.V	To cut all the grass, crop or any thin plants of a surface area of the ground.
Agriculture:paddy field.N	A flooded field where rice is grown.
Agriculture:paddy.N	Wet land in which rice is grown.
Agriculture:pick.V	To take off the fruits or other useful parts of a plant.
Agriculture:pitchfork.N	An agricultural tool comprising a fork attached to a long handle used for pitching hay or bales of hay high up onto a haystack.
Agriculture:plough.N	An agricultural device pulled through the ground in order to break it open into furrows for planting.
Agriculture:plough.V	To use a plough on to prepare for planting.
Agriculture:pull up (rice seedlings).V	To pull out rice seedlings from the soil including their roots in order to separate seedlings growing too closely
Agriculture:pull up weeds.V	To remove weeds from e.g. a field.
Agriculture:rake.N	A garden tool with a row of pointed teeth fixed to a long handle, used for collecting grass or debris, or for loosening soil.
Agriculture:scatter (seeds).V	To distribute seeds over a field.
Agriculture:shepherd.N	The person that watches over sheep.
Agriculture:shovel.N	A tool consisting of a stick (usually out of wood) and a bigger, slightly humped surface (usually out of metal), which is used to move material such as earth, snow, grain, etc. from one place to another.
Agriculture:sickle or scythe.N	Any portable tool that is used to cut grass or cereal crops in agriculture.
Agriculture:sickle.N	An implement, having a semicircular blade and short handle, used for cutting long grass and cereal crops in agriculture.
Agriculture:sow seeds.V	To scatter or disperse seeds on a field.
Agriculture:swidden field.N	A piece of land cleared for farming by burning away vegetation.
Agriculture:thresh.V	Separating the grain from the straw or husks by beating.
Agriculture:threshing-floor.N	Dry flat area where the grain is separated from the straw or husks by beating.
Agriculture:till.V	Prepare land for cultivation by work such as ploughing, harrowing, and manuring.
Agriculture:winnowing.V	Wind winnowing is an agricultural method developed by ancient cultures for separating grain from chaff.
Animal:Acridomorpha.N	A plant-eating insect with long back legs that can jump very high and makes a sharp high noise using its back legs or wings.
Animal:Anatidae.N	An aquatic bird of the family Anatidae, having a flat bill and webbed feet.
Animal:animal.N	Any living organism characterized by voluntary movement, the possession of cells with noncellulose cell walls and specialized sense organs enabling rapid response to stimuli, and the ingestion of complex organic substances such as plants and other animals.
Animal:Annelida.N	A generally tubular invertebrate of the annelid phylum.
Animal:Anthophila.N	Any of the membranous-winged insects which compose the superfamily Apoidea in the order Hymenoptera characterized by a hairy body and by sucking and chewing mouthparts.
Animal:Anura.N	Any insectivorous anuran amphibian of the family Ranidae, such as Rana temporaria of Europe, having a short squat tailless body with a moist smooth skin and very long hind legs specialized for hopping.
Animal:Araneae.N	Any predatory silk-producing arachnid of the order Araneae, having four pairs of legs and a rounded unsegmented body consisting of abdomen and cephalothorax.
Animal:Asian dragon.N	A mythical creature typically depicted as a large horned serpent with claws and with magical or spiritual qualities.
Animal:Aves.N	Any of the bipedal, warm-blooded vertebrates that lay eggs having wings which, for most species, enables them to fly.
Animal:Blattodea.N	The most primitive of the living winged insects.
Animal:Bos taurus.N	Domesticated bovine animals, including cows, steers and bulls, raised and bred on a ranch or farm.
Animal:Canis lupus familiaris.N	A common four-legged animal, especially kept by people as a pet or to hunt or guard things.
Animal:Canis lupus.N	A large wild canid (Canidae), closely related to the dog.
Animal:Canis.N	Refers to *genus canis*, a genus containing seven to ten extant species, including wolves, domestic dogs, coyotes, and jackals.
Animal:Capra hircus.N	A common four-legged animal (Capra) that is related to sheep and bred by humans for its coat and milk.
Animal:Cervidae.N	The common name for 41 species of even-toed ungulates that compose the family Cervidae in the order Artiodactyla; males have antlers.
Animal:Cetacea.N	Large marine mammals of the order Cetacea; the body is streamlined, the broad flat tail is used for propulsion, and the limbs are balancing structures.
Animal:Corvus.N	A bird, usually black, of the genus Corvus, having a strong conical beak, with projecting bristles; it has a harsh, croaking call.
Animal:Culicidae.N	A small flying insect (of the family Culicidae) known for biting and sucking blood.
Animal:Diptera.N	A common insect; any species of insect of the order Diptera.
Animal:dragon.N	A mythical creature typically depicted as a winged, fire-breathing reptile with magical qualities.
Animal:dung.N	Animal faeces.
Animal:Elephantidae.N	A mammal of the order Proboscidea, having a trunk, and two large ivory tusks jutting from the upper jaw. Elephants are the largest land animals now existing.
Animal:Equus asinus.N	A domesticated animal, Equus asinus.
Animal:Equus ferus caballus.N	A large animal with four legs of the Equus caballus species which people ride on or use for carrying things or pulling vehicles.
Animal:Felis catus.N	A common four-legged animal (Felis silvestris) that is often kept as a household pet.
Animal:Felis leo.N	A large cat (Panthera leo) that is native to Africa, Asia and formerly much of Europe.
Animal:Felis tigris.N	A large carnivorous animal (Panthera tigris) of the cat family indigenous to Asia.
Animal:female in general.A	Of, relating to, or denoting the sex which is generally characterized as the one associated with the larger gametes (for species which have two sexes and for which this distinction can be made).
Animal:female.A	Relating to the female sex of animals (adjective).
Animal:female.N	A female animal (Noun)
Animal:fish.N	A cold-blooded vertebrate animal that lives in water that moves with the help of fins and breathes using gills (Pisces).
Animal:Formicidae.N	Any of the black, red, brown, or yellow insects of the family Formicidae characterized by a large head and by living in organized colonies.
Animal:Gallus gallus domesticus.N	A type of domesticated bird from the order of Galliformes which is often raised as a type of poultry (Gallus gallus domesticus).
Animal:Grylloidea.N	Insects related to grasshoppers.
Animal:Homo sapiens.N	A human being, any living member of Homo sapiens.
Animal:Hydrochoerus hydrochaeris.N	The largest living rodent native to South America, living partly on land and partly in water.
Animal:Insecta.N	A class of the Arthropoda typically having a segmented body with an external chitinous covering, a pair of compound eyes, a pair of antennae, three pairs of mouthparts, and two pairs of wings.
Animal:Lacertidae.N	Any reptile of the suborder Lacertilia, especially those of the family Lacertidae, typically having an elongated body, four limbs, and a small tail: includes the gechos, iguanas, chameleons, monitors, and slow worms.
Animal:Lampyridae.N	A nocturnal, bioluminescent beetle of the family Lampyridae.
Animal:Leporidae.N	One of several small mammals of the family Leporidae, with long ears, long hind legs and a short, fluffy tail.
Animal:male in general.A	Of, relating to, or denoting a member of the sex that begets young by fertilizing ova.
Animal:male.A	Relating to the male sex of animals.
Animal:male.N	A male animal (Noun)
Animal:Mantodea.N	A predatory insect of the order Mantodea; mantid; praying mantis.
Animal:Meleagris gallopavo.N	A large bird from the family of Phasanidae.
Animal:mouse.N	Any of numerous small rodents of the genus ''mus'' or various related genera of the ''Murid√¶'' family characterised by a long hairless tail, rounded ears, and a pointed nose.
Animal:Nephropidae.N	Clawed lobsters comprise a family (Nephropidae, sometimes also Homaridae) of large marine crustaceans.
Animal:Ovis aries.N	A common, four-legged animal (Ovis) that is commonly kept by humans for its wool.
Animal:Passeridae.N	A small song bird, in the family Passeridae.
Animal:pet.N	An animal or a bird that is kept at home for companionship rather than for practical use.
Animal:Rhopalocera.N	A lepidopteran that is active at day.
Animal:Sciuridae.N	A small or medium-sized rodent of the family Sciuridae.
Animal:Serpentes.N	Any reptile of the suborder Serpentes, typically having a scaly cylindrical limbless body, fused eyelids, and a jaw modified for swallowing large prey.
Animal:Simiiformes.N	A primate from the group *New World monkeys* or *Old World monkeys* (Simiiformes, excluding the superfamily Hominoidea or apes) that lives mainly in rainforests and is distinguished from an Ape by its smaller size and its tail.
Animal:Sus scrofa domestica.N	A common, four-legged animal (Sus scrofa) that has cloven hooves, bristles and a nose adapted for digging and is farmed by humans for its meat.
Animal:Tamias.N	A squirrel-like rodent of the genus Tamias, native mainly to North America.
Animal:Testudines.N	A reptile of the order Testudines (the crown group of the superorder Chelonia), characterised by a special bony or cartilaginous shell developed from their ribs that acts as a shield.
Animal:unicorn.N	A legendary animal with a horn on the forehead.
Animal:Ursidae.N	A large beast of prey of the family Ursidae, related to the dog and raccoon, having shaggy hair, a very small tail, and flat feet.
Animal:Vespinae.N	A flying stinging insect related to the bee, which is usually coloured yellow and black.
Animal:Vulpes.N	A carnivorous relatively small canine of the species Vulpes Vulpes.
Animal:wool.N	The soft, curly hair that forms the fleece of sheep, lamas and other animals and which is used to produce clothing.
Art:sculptor.N	A person who practices the art of sculpture.
Art:statue.N	A three-dimension work of art, usually of a person or animal, usually created by sculpting, carving, moulding, or casting.
Atmosphere:climate.N	Climate is the long-term pattern of weather in a particular area.
Atmosphere:cloud or fog.N	High or low elevation water suspensions.
Atmosphere:cloud.N	Suspensions of minute water droplets or ice crystals produced by the condensation of water vapour.
Atmosphere:cold weather.N	A period of time, characterized by low temperatures.
Atmosphere:cold.A	Having a low temperature (of the weather).
Atmosphere:fan (action).V	To blow air on (something) by means of a fan (hand-held, mechanical or electrical) or otherwise.
Atmosphere:fan (object).N	A device for creating a current of air by movement of a surface or surfaces. (WN:360)
Atmosphere:fog.N	Water droplets or, rarely, ice crystals suspended in the air in sufficient concentration to reduce visibility appreciably.
Atmosphere:foggy.A	A thick layer of fog.
Atmosphere:hail.N	Precipitation in the form of balls or irregular lumps of ice.
Atmosphere:hailing.V	To fall from the clouds in form of ball or lumps of ice.
Atmosphere:hot weather.N	A period of unusually high temperatures.
Atmosphere:humid.A	(Of the air) Containing a high quantity of water vapor.
Atmosphere:muggy.A	A type of weather when it is hot and the air is damp.
Atmosphere:rain.N	Precipitation in the form of liquid water drops with diameters greater than 0.5 millimeters.
Atmosphere:rain.V	To fall from the clouds in drops of water.
Atmosphere:rainbow.N	A multicoloured arc in the sky caused by the refraction of light within droplets of rain in the air.
Atmosphere:raining or rain.N	The process by which water falls from the clouds or the water that falls from the clouds.
Atmosphere:sky.N	The part of the earth's atmosphere and space outside it that is visible from earth's surface. During the day it is perceived as blue, and at night as black.
Atmosphere:storm clouds.N	Darkish clouds attending a windstorm.
Atmosphere:storm.N	An atmospheric disturbance involving perturbations of the prevailing pressure and wind fields on scales ranging from tornadoes to extratropical cyclones; also the associated weather and the like. (Source: MGH)
Atmosphere:thunder.N	Sound produced by fast air expansion induced by a lightning.
Atmosphere:thunder.V	The process producing the noise after a lightning.
Atmosphere:warm.A	Having a pleasant temparture (of weather).
Atmosphere:weather.N	The day-to-day meteorological conditions, especially temperature, cloudiness, and rainfall, affecting a specific place.
Atmosphere:whirlwind.N	A rapidly rotating, tall column of air, moving over land or sea and causing damage.
Atmosphere:wind.N	The motion of air relative to the earth's surface; usually means horizontal air motion, as distinguished from vertical motion.
Atmosphere:windy.A	When there is a lot of wind.
Belief:altar.N	Table for religious ceremonies.
Belief:amulet.N	An object whose most important characteristic is the power ascribed to it to protect its owner from danger or harm.
Belief:angel.N	A supernatural messenger from a god, often depicted in art as a youthful winged human figure.
Belief:atheism.N	atheism
Belief:bishop.N	
Belief:bless.V	To confer divine aid or favor upon someone or something.
Belief:buddha.N	One who has purified obscurations and developed pristine cognition.
Belief:Buddhism.N	Buddhism
Belief:Catholic priest.N	A minister of the Catholic church empowered to administer the sacraments, most particularly that of the Eucharist or Holy Communion, as well as those of confession and extreme unction.
Belief:Christ.N	
Belief:Christianity.N	Christianity
Belief:Christmas.N	Christmas or Christmas Day (Old English: Crƒ´stesm√¶sse, meaning Christ's Mass) is an annual festival commemorating the birth of Jesus Christ, observed most commonly on December 25 as a religious and cultural celebration among billions of people around the world.
Belief:curse.V	To imprecate evil or misfortune upon someone or something, usually by means of a prayer or implication.
Belief:deity.N	A supernatural, typically immortal being with superior powers.
Belief:demon.N	Evil spirit or person that is wicked or cruel in their actions.
Belief:Devil.N	The personal supreme spirit of evil often represented in Christian belief as the tempter of humankind, the leader of all apostate angels, and the ruler of hell.
Belief:Easter.N	
Belief:fairy (fem).N	One of a class of female supernatural beings, generally conceived as having a diminutive human form and possessing magical powers.
Belief:fairy.N	A supernatural flying humanoid possessing magical powers.
Belief:false idol.N	A representation of a deity who is considered to be false.
Belief:funeral.N	The ceremonial act of bidding farewell to a deceased person or animal.
Belief:ghost.N	The visible disembodied soul of a dead person.
Belief:God.N	The deity of a monotheistic religion.
Belief:heaven.N	The abode of gods sometimes believed to be in the sky.
Belief:hell.N	In various religions, the place where sinners are said to go after death.
Belief:Hinduism.N	Hinduism
Belief:holiday.N	A religious feast day.
Belief:holy.A	Specially recognized as or declared sacred by religious use or authority.
Belief:hymn.N	
Belief:idol.N	A representation of a deity, notably a statue or a statuette.
Belief:Islam.N	Islam
Belief:Judaism.N	Judaism
Belief:legendary creature.N	A human or an animal described in non-historical or yet to be verified stories that sometimes involve the supernatural.
Belief:Lent.N	
Belief:magic.N	The use of rituals or actions, especially based on supernatural or occult knowledge, to manipulate or obtain information about the natural world, especially when seen as falling outside the realm of religion.
Belief:magician.N	A person who practices magic.
Belief:miracle.N	The happening of something impossible.
Belief:mosque.N	A place of worship for followers of the Islamic faith.
Belief:Muslim.N	A believer of Islam.
Belief:mythical being.N	Any living creature that occurs in stories and fairytales and does not exist in the real world.
Belief:omen.N	A sign that is supposed to reveal whether the future will be favourable or not.
Belief:pray.V	To address God or a higher being with praise, thanksgiving, confession or supplication.
Belief:priest.N	A generic way of referring to a person of religious authority, like a priest or a shaman, irrespective of specific religious schools.
Belief:pyre.N	Structure made from wood for burning a body as part of a rite.
Belief:religion.N	The expression of man's belief in and reverence for a superhuman power recognized as the creator and governor of the universe.
Belief:rite.N	A specific process or action used to practise religious beliefs.
Belief:rosary.N	
Belief:sacred grove.N	A place in nature believed to hold special religious, magical, etc. powers.
Belief:Santa Claus.N	Santa Claus, also known as Saint Nicholas, Father Christmas, Kris Kringle and simply Santa, is an important figure with legendary, historical and folkloric origins who, in many Western cultures, is said to bring gifts to the homes of the good children on 24 December, the night before Christmas Day.
Belief:sermon.N	A religious lecture or speech, addressing issues of religion or morality.
Belief:sermon.V	To deliver a sermon.
Belief:shaman.N	A traditional (prescientific) faith healer; a member of certain tribal societies who acts as a religious medium between the concrete and spirit worlds.
Belief:shaman‚Äôs spirit.N	
Belief:shamanistic song.N	
Belief:soul.N	In philosophical or religious belief the immaterial part of a human being that is believed to outlive the body.
Belief:sphinx.N	A fable animal that occurs in Greek mythology.
Belief:spirit.N	A spiritual entity that is not as powerful as a deity.
Belief:temple.N	A house of worship and spiritual activities.
Belief:witch.N	A female person who practices magic.
Belief:woman‚Äôs rattle.N	
Belief:worship.V	To show devotion and obeisance to.
Body:ankle.N	A joint formed where the foot and the leg meet.
Body:anus.N	The lower opening of the digestive tract, through which faeces pass.
Body:arm or hand.N	Extremities emerging from the upper part of the human body.
Body:arm.N	The upper limb, extending from the shoulder to the wrist and sometimes including the hand.
Body:armpit.N	The hollow under the upper part of the arm at the shoulder.
Body:artery.N	A blood vessel transporting blood away from the heart.
Body:back of head.N	The back part of the head.
Body:back.N	The rear of body, especially the part between the neck and the end of the spine and opposite the chest and belly.
Body:bald.A	Without hair on the head.
Body:beak.N	External anatomical structure of birds which is used for taking food and for eating.
Body:beard.N	Facial hair of humans on the chin, cheeks and jaw.
Body:belch.V	To release gas from the digestive tract through the mouth.
Body:belly or stomach.N	The lower part of the front of the torso, including the interior part below.
Body:belly.N	The lower part of the front of the torso (or a comparable part of an animal), confined by the upper side by the midriff and the lowerside by the pelvis. Contains the intestines.
Body:bellybutton.N	The middle of the belly where the umbilical cord has grown in the womb during pregnancy.
Body:bile.N	A bitter brownish-yellow or greenish-yellow secretion produced by the liver, stored in the gallbladder, and discharged into the duodenum where it aids the process of digestion.
Body:bladder.N	A hollow muscular balloon-shaped organ that stores urine until it is excreted from the body.
Body:bleed.V	To lose blood because of a disease or an injury.
Body:blink.V	To make a quick wink of one or both eyelids, often repeatedly.
Body:blister.N	A small bubble on the skin, that contains watery fluid and is caused by heat, pressure or infection.
Body:blood vessel.N	The blood vessels are the part of the circulatory system that transports blood throughout the human body or an animal body.
Body:blood.N	A fluid connective tissue consisting of the plasma and cells that circulate in the blood vessels.
Body:blow nose.V	To clean one's nose by exhaling through it.
Body:blow.V	To expel air through persed lips.
Body:body hair.N	The terminal hair that develops on the human body during and after puberty.
Body:body part.N	Part of a human body or an animal body.
Body:body.N	The physical structure of a human or animal.
Body:boil.N	A painful, local inflammation of the skin, caused by infection of a hair follicle. Usually, a hard core and pus are present.
Body:bone.N	Any of the components of an endoskeleton, consisting mainly of calcium phosphate, collagen and cells.
Body:brain.N	The organ of the central nervous system of an animal or human located in the skull that controls the actions and thoughts of the animal or human.
Body:breast milk.N	The milk of humans.
Body:breast or milk.N	Either the organ of females which gives nourishing substance for newborns, or the substance itself.
Body:breast.N	The fleshy organ on the chest of a sexually mature human female containing mammary glands.
Body:breastbone.N	Long flat bone located in the center of the chest.
Body:breath.N	The air inhaled and exhaled through the lungs.
Body:breath.V	To repeatedly draw air into, and expel it from, the lungs, in order to extract oxygen from it and excrete waste products.
Body:bruise.N	A collection of blood in the body tissue outside the blood vessels
Body:burn.N	An injury caused by exposure to heat, fire or chemical agents.
Body:burp.V	To release gas from the digestive tract through the mouth.
Body:buttock.N	The fleshy part of the human body that one sits on.
Body:calf of leg.N	The fleshy backside of the lower part of the leg.
Body:canine tooth.N	One of the pointed teeth behind the incisors and in front of the premolar teeth.
Body:carcass.N	The body of a dead animal, on which other animals have begun to feed.
Body:cheek.N	The soft skin on each side of the face, between the eyes and the chin; the outer surface of the sides of the oral cavity.
Body:chest.N	The portion of the body from the base of the neck to the top of the abdomen; the thorax.
Body:chin.N	The bottom of the face, below the mouth.
Body:cholesterol.N	
Body:claw or nail.N	The hard, keratin part growing at the feet of animals or the hands and legs of humans.
Body:clitoris.N	A part of the female genitalia located at the front of the vulva, consisting of a sensitive erectile body.
Body:close (eyes).V	Move ones eyelids in such a way that the eyes are no longer visible.
Body:close eyes.V	To shut down the eyes such that one cannot see anything anymore.
Body:close mouth.V	To close one's mouth.
Body:collarbone.N	Bone linking the scapula and sternum.
Body:corpse.N	A dead body.
Body:coughing.N	The act of coughing or the sound of coughing.
Body:dribble.N	
Body:dribble.V	To let saliva flow out of one‚Äôs mouth onto one‚Äôs chin.
Body:ear.N	The organ of hearing, consisting of the pinna, auditory canal, eardrum, malleus, incus, stapes and cochlea.
Body:earhole.N	The outer opening of the ear.
Body:earlobe.N	The lower fleshy part of the human ear.
Body:earwax.N	A yellowish, waxlike secretion from certain glands in the external auditory canal.
Body:egg.N	egg
Body:elbow.N	The joint between arm and forearm.
Body:eye.N	The organ that is sensitive to light, which it converts to electrical signals passed to the brain, by which means animals and humans see.
Body:eyeball.N	The partly visible orb nesting in the eye socket which contains for example pupil, retina and iris and is connected to the brain via the optic nerve.
Body:eyebrow.N	The hair that grows over the bone ridge above the eye socket.
Body:eyelash.N	One of the hairs that grows on the eyelid, around the eyes.
Body:eyelid.N	A skin flap that can be closed over an eye.
Body:face.N	The front part of the head, featuring the eyes, nose, and mouth and the surrounding area.
Body:fart.V	To emit digestive gases through the anus.
Body:fat.N	Esters of three fatty acid chains and the alcohol glycerol which form a semi-solid substance in room temperature and occur in animals and plants.
Body:feather.N	A branching, hair-like structure that grows on the skin of birds and protects them against coldness and water and allows their wings to create lift.
Body:feces.N	Substance that human and animal bodies release from time to time as a little pile of waste remaining from digestion, after it has been collected in the colon.
Body:feces.V	To excrete faeces from one's body through the anus.
Body:finger or toe.N	Limb of the human body found in the hands and foots of humans and primates.
Body:finger.N	One of the long extremities of the hand that is used for gripping objects.
Body:fingernail.N	The hard, flat, translucent covering near the tip of a human finger, useful for scratching and fine manipulation.
Body:fingertip.N	The top of the finger.
Body:fishbone.N	Any of the bones forming the skeleton of a fish, especially one of the sharp slender bones attached to the backbone.
Body:fist.N	The closed hand with the fingers on the palm.
Body:flesh or meat.N	Either referring to the soft substance of the body of living things (flesh), or to the soft substance in animals as an important source of food for humans.
Body:flesh.N	The soft substance in the body of living things.
Body:foot or leg.N	Lower part of the human body which is used for walking.
Body:foot.N	The part of a human‚Äôs body below the ankle that is used in order to stand and walk.
Body:footprint.N	The impression of the foot in a soft substance such as sand or snow.
Body:forefinger.N	The finger between thumb and long finger.
Body:forehead.N	The part of the face between the hairline and the eyebrows.
Body:front tooth.N	Aeveral teeth located above and below in the mouth of mammals (including humans) to bite food off.
Body:fur.N	The body-hair of an animal (excluding humans) or a piece of clothing made thereof.
Body:gall bladder.N	A pear-shaped organ located beneath the liver that serves as a storage sac for bile until it is released into the small intestine.
Body:genitalia.N	The sexual organs: the testicles and penis of a male; or the labia, clitoris, and vagina of a female.
Body:goiter.N	Enlargement of the thyroid gland.
Body:gum.N	The mucosal tissue that partly lies over the teeth in the mouth.
Body:guts.N	The internal organs of an animal or human.
Body:hair.N	The hair on humans, usually on the head but also including the hair on the body.
Body:hand.N	That part of the fore limb below the forearm or wrist in primates (including humans).
Body:head hair.N	The hair on the head of humans (rather than the hair in general or the hair on the body).
Body:head.N	The part of the body of an animal or human which contains the brain, mouth and main sense organs.
Body:heart.N	A muscular organ that pumps blood through the body.
Body:heel.N	The part of the human foot on the backside where it becomes the leg.
Body:hip.N	The outward-projecting parts of the pelvis and top of the femur and the overlying tissue.
Body:hoof.N	Natural horn covering of an animal's foot.
Body:horn.N	A hard growth of keratin that protrudes from the top of the head of certain animals.
Body:human skin.N	The outer tissue of human beings.
Body:intestines.N	The alimentary canal of an animal or human through which food passes after having passed all stomachs.
Body:jaw.N	Either of the two opposable structures forming, or near the entrance to, the mouth.
Body:joint.N	Any part of the body where two bones join.
Body:kidney.N	An organ in the body that produces urine.
Body:knee.N	In man, the joint in the middle part of the leg.
Body:knuckle.N	Joints of the fingers brought to prominence when hand is clenched.
Body:lap.N	The front area from waist to knees, especially when sitting.
Body:larynx.N	Organ on the upper end of the trachea.
Body:lay eggs.V	The process by which birds produce eggs.
Body:left hand.N	The left hand of a human.
Body:leg.N	The limb of an animal (including humans) that extends from the groin to the ankle.
Body:lip.N	Either of the two fleshy protrusions around the opening of the mouth.
Body:liver.N	A large organ in the body that stores and metabolizes nutrients, destroys toxins and produces bile. Responsible for thousands of biochemical reactions.
Body:loin.N	The part of the body (of humans and quadrupeds) each side of the backbone between the ribs and hips.
Body:lower arm.N	The part of the arm between the elbow and the hand.
Body:lower back.N	The lower part of the spine, also known as the lumbar region, which is situated between the rib cage and the pelvis.
Body:lower leg.N	Part of the leg between the knee and the foot.
Body:lower lip.N	The lower fleshy protrusion around the opening of the mouth.
Body:lung.N	A biological organ that extracts oxygen from the air.
Body:mane.N	The long hair in the neck of horses and lions.
Body:marrow.N	The spongy tissue in the hollow parts of bones.
Body:menstruate.V	Regular natural change in female reproductive system that makes pregnancy possible.
Body:menstruation.N	The period in the menstrual cycle when the endometrium is shed when conception did not take place.
Body:middle finger.N	The third and longest finger on the human hand.
Body:molar tooth.N	A tooth located in the back of the mouth used for crushing and grinding food.
Body:moustache.N	A growth of facial hair between the nose and the upper lip.
Body:mouth.N	Opening in the lower half of a human face which is used for food ingestion and articulation.
Body:muscle.N	An organ formed by contractile tissue that moves other organs.
Body:nail.N	Hard keratin part growing at the end of a human's finger or toe.
Body:nape.N	The back part of the neck.
Body:navel.N	A scar where the umbilical cord was attached.
Body:neck.N	The part of the body (found in some animals, including humans) that connects the head and the trunk.
Body:nerve.N	An enclosed, cable-like bundle of axons (nerve fibers, the long and slender projections of neurons) in the peripheral nervous system.
Body:nipple.N	The projection of a mammary gland from which, on female mammals, milk can be secreted.
Body:nose.N	The organ of the face used to breath and smell.
Body:nostril.N	Either of the two orifices located on the nose (or on the beak of a bird); used as a passage for air and other gases to travel the nasal passages.
Body:obese.A	Carrying a larger-than-normal amount of fat or weight.
Body:open (eyes).V	Move ones eyelids in such a way that the eyes are visible.
Body:open (mouth).V	To move one's jaw(s) in a way that the oral cavity becomes partially or fully visible.
Body:organ.N	organ (of body)
Body:ovary.N	The female sex organ which is often paired and produces eggs for procreation.
Body:palate.N	The palate is the roof of the mouth in humans and other mammals.
Body:palm.N	The inner and somewhat concave part of the human hand that extends from the wrist to the bases of the fingers.
Body:pancreas.N	An organ of the digestive system of vertebrates.
Body:penis.N	The male sexual organ for copulation and urination; the tubular portion of the male genitalia (excluding the scrotum).
Body:pharynx.N	The inner part of the neck which starts after the oral and nasal cavity.
Body:phlegm.N	Mucus secreted by the respiratory tract, particularly during respiratory infections, usually thick and sticky.
Body:pimple.N	A result of a blockage of the skin's pore.
Body:piss.N	Liquid excrement consisting of water, salts and urea, which is made in the kidneys, stored in the bladder, then released through the urethra.
Body:piss.V	To allow urine to flow from the bladder out of the body.
Body:placenta.N	A vascular organ that is formed inside the womb to ensure the transfer of vital nutrients and regulation of metabolic exchange between mother and the foetus.
Body:pubic hair.N	Dense, coarse hair that grows on the male and female genital area beginning in puberty.
Body:pulse.N	The rhytmic contraction and expansion of arteries at each heart beat, often discernible at points such the wrists and the neck.
Body:pupil.N	Contractile aperture in iris.
Body:rest or sleep.V	Lie down or sleep.
Body:rib.N	One of the long curved bones which form the rib cage.
Body:right hand.N	The right hand of a human.
Body:saliva.N	A secretion from the salivary glands (found in the mouth) that can be spat out.
Body:scab.N	A hard coating on the skin formed during the wound healing reconstruction phase.
Body:scar.N	A permanent mark on the skin resulting from a wound.
Body:scrotum.N	Anatomical male reproductive structure.
Body:semen.N	An organic fluid that may contain spermatozoa. It is secreted by the gonads (sexual glands) and other sexual organs of male or hermaphroditic animals and can fertilize female ova.
Body:shell.N	A hard outer covering of an animal, as the hard case of a mollusk.
Body:shin.N	The front part of the leg below the knee.
Body:shoulder.N	One side of the top of the torso, where an arm attaches or joins.
Body:shoulderblade.N	A large flat bone located at the back of each shoulder.
Body:side.N	The side of the body.
Body:skeleton.N	The body part that forms the supporting structure inside of the human body or the body of animals.
Body:skin.N	The tissue forming the outer covering of the vertebrate body: it consists of two layers, the outermost of which may be covered with hair, scales, feathers, etc. It is mainly protective and sensory in function.
Body:skull.N	The main bone of the head; the cranium.
Body:smallpox.N	A highly contagious viral disease characterized by fever and weakness and skin eruption with pustules that form scabs that slough off leaving scars.
Body:sneeze.V	To expel air rapidly as a reflex, usually induced by an irritation in the nose.
Body:sole.N	The bottom of the foot.
Body:sperm.N	Men's semen.
Body:spine.N	The body part that consists of a row of vertebrae, that support the head and torso and that forms a canal for nerves.
Body:spit.V	To forcefully evacuate saliva from the mouth.
Body:spleen.N	A ductless vascular gland, located in the left upper abdomen near the stomach.
Body:stomach.N	An organ in the body, involved in digestion of food.
Body:sweat.N	A fluid that is secreted by sweat glands in the skin in order to regulate body temperature.
Body:sweat.V	To secrete sweat.
Body:swell.A	Swollen.
Body:swell.N	Abnormal protuberance or localized enlargement.
Body:tail.N	The appendage of an animal that is attached to its posterior and near the anus.
Body:tear.N	A drop of liquid produced from the eyes by crying or irritation.
Body:temple.N	The region of the skull on either side of the forehead.
Body:tendon.N	Tissue that connects muscle to bone.
Body:testicle.N	The male sex gland that produces sperm and male hormones, found in some types of animals and humans.
Body:thigh.N	The area between the pelvis and buttocks and the knee.
Body:throat.N	The front part of the neck.
Body:thumb.N	The shortest and thickest of the fingers that can be placed against the others in order to create a firm grip.
Body:toe.N	One of the extremities of the foot.
Body:toenail.N	The hard keratin substance covering the tips of the feet of human beings.
Body:tongue tip.N	The front part of the tongue.
Body:tongue.N	The flexible muscular organ in the mouth that is used to move food around, for tasting and that is moved into various positions to modify the flow of air from the lungs in order to produce different sounds.
Body:tooth.N	A hard, calcareous structure present in the mouth of many vertebrate animals (including humans), generally used for eating.
Body:torso.N	The central part of the human body, from which neck and limbs extend.
Body:udder.N	An organ in female quadruped mammals which consists of mammary glands and has several teats.
Body:ulcer.N	An open sore of the skin, eyes or mucous membrane, often caused by an initial abrasion and generally maintained by an inflammation and/or an infection.
Body:umbilical cord.N	A conduit between the developing embryo or fetus and the placenta.
Body:upper arm.N	The part of the arm between the shoulder and the elbow.
Body:upper back.N	The upper part of the back.
Body:upper leg.N	The part of the leg between the pelvis and the knee.
Body:uvula.N	A conic projection from the posterior edge of the middle of the soft palate.
Body:vagina.N	The lower part of the female reproductive tract; a moist canal in female mammals (including humans) extending from the labia minora to the uterus.
Body:vein.N	A blood vessel that transports blood from the capillaries back to the heart.
Body:vulva.N	The external parts of the female genitalia, in human beings this consists of the labia, clitoris, opening of the urethra (meatus), and the opening of the vagina.
Body:waist.N	In human beings, the part between the thorax and hips.
Body:wart.N	Typically small, rough, and hard growths that are similar in color to the rest of the skin.
Body:wing.N	The appendage of an animal's (bird, bat, insect) body that enables it to fly in the air.
Body:womb.N	The major female reproductive organ of most mammals, including humans. It is a large muscle enveloping the phoetus during pregnancy.
Body:wound.N	A type of injury in which in skin or tisue is torn, cut,  punctured or otherwise hurt.
Body:wrinkle.N	A fold, ridge or crease in the skin.
Body:wrist.N	The flexible and narrower connection between the forearm and the hand.
Body:yawn.V	To open the mouth widely and take a long, deep breath because of tiredness or boredom.
Building:adobe.N	An unburnt brick dried in the sun made of clay and dried grasses.
Building:arch.N	An arch-shaped arrangement of trapezoidal stones, designed to redistribute downward force outward.
Building:area under house.N	The area under a house.
Building:beam.N	A structural member loaded on its narrow face, and typically used in a horizontal or sloping position to span between bearing points.
Building:board.N	A piece of wood or similar material that has been sawn into a regular shape, usually in preparation for using it in some sort of construction.
Building:brick.N	A building material usually made from clay, molded as a rectangular block, and baked or burned in a kiln.
Building:build.V	To form by combining materials or parts.
Building:building.N	A solid construction comprised of walls and a roof.
Building:camp.N	Tents, cabins, etc., used as temporary lodgings by a group of travellers, holiday-makers, Scouts, Gypsies, etc.
Building:ceiling.N	ceiling
Building:cellar.N	cellar, basement
Building:chimney.N	A vertical structure of brick, masonry, or steel that carries smoke or steam away from a fire, engine, etc.
Building:church.N	Building or institution of public worship in Christianity.
Building:column.N	An upright supporting beam.
Building:cookhouse.N	A small house where cooking takes place; a kitchen house.
Building:corrugated iron.N	An iron sheet building material, usually galvanised, which has been pressed into corrugations.
Building:courtyard.N	An area wholly or partly surrounded by walls or buildings.
Building:dam.N	A wall to stop or control the flow of a stream or river.
Building:deck.N	The deck, a raised flat surface that can be walked on.
Building:door.N	An opening, or passage in a fence or wall; the entrance through which you enter or leave a room or building.
Building:doorpost.N	The frame that supports a door.
Building:doorsill.N	A horizontal member of wood, stone, etc, forming the bottom of a door frame on which the threshold is put on.
Building:fireplace.N	An open recess in a wall at the base of a chimney where a fire may be built.
Building:floor.N	The bottom or lower part of any room; the supporting surface of a room.
Building:frame.N	frame (structure supporting or surrounding something)
Building:frame.N	A structural system of support.
Building:garden-house.N	A small building in a garden, such as a shed, which is not usually build to be inhabitated for long times.
Building:gate.N	A gate or gateway is a point of entry to a space which is enclosed by walls.
Building:house.N	The abode of a human being, their place of residence.
Building:hut.N	A simple roofed shelter, often with one  open side.
Building:igloo.N	A snow hut built from snow and serving as a shelter.
Building:mason.N	A craftsman who builds in stone or brick otherwise known as masonry.
Building:mortar binder.N	Paste made of a mixture of a binder (cement, plaster or lime), sand and water used in masonry to make bricks, stones, etc. stick together.
Building:porch.N	A structure attached to the exterior of a building, often acting as a roofed entrance; a balcony; a veranda.
Building:post.N	A strong upright piece of wood, metal etc. that is fixed into the ground, especially to support something.
Building:pyramid.N	A structure whose outer surfaces are triangular and converge to a single point at the top.
Building:rafter.N	One of several parallel sloping beams that extend from the ridge to the wall-plate, to support the roof and its associated loads; the sloping top member of a roof truss, which carries the purlins.
Building:ridgepole.N	The highest horizontal beam in a roof.
Building:roof.N	The structure covering a building.
Building:room.N	A separate part of a building, enclosed by walls, a floor and a ceiling.
Building:shed.N	A building for storing agricultural products or sheltering livestock.
Building:stairs.N	A contiguous set of steps connecting two floors.
Building:step.N	A flat surface or support that facilitates the ascent or descent of a stairway or step-ladder.
Building:tent.N	A portable lodging (usually made from waterproof plastic, animal hide or canvas streched by poles) that is used for sheltering people and objects from the weather when camping or at festivals.
Building:thatch or roof.N	The cover of a house or a hut.
Building:thatch.N	Natural roofing material such as straw, reeds, leaves, etc.
Building:threshold.N	The bottom-most part of a doorway that one crosses to enter; a sill.
Building:tile.N	The long-lasting material that is manufactured in multiple pieces and used for covering flat surfaces of a building, such as a roof, walls, or floor.
Building:tower.N	Structure, usually taller than it is wide, often used as a lookout.
Building:wall or barrier.N	A supporting structure for different types of constructions, e.g. houses and huts, or a construction to enclose and separate areas.
Building:wall.N	The outer structure which encloses a building and supports the roof.
Building:windmill.N	A large structure or building with long revolving blades or sails that is used for converting wind energy in order to produce electricity or to directly power an attached mechanical construction for grinding.
Building:window.N	An opening, usually covered by one or more panes of clear glass, to allow light from outside to enter a building or vehicle.
Building:yard.N	A small, usually uncultivated area adjoining or within the precincts of a house or other building.
Cleaning:broom.N	A tool used to sweep and clean the floor, made of a bundle of straws or twigs attached to a long handle.
Cleaning:clean (sth).V	To cause something to be no longer dirty.
Cleaning:clean.A	Not dirty.
Cleaning:dirt.N	Any unclean substance, such as mud, dust, dung etc.
Cleaning:dirty.A	Covered with or containing unpleasant substances such as dirt or grime.
Cleaning:sweep.V	To clean a surface with a broom.
Cleaning:vacuum (sth).V	Clean something by using a vacuum cleaner.
Cleaning:wash (clothes).V	To clean pieces of clothing by using water and supplementary cleansing products as a part of hygiene routine.
Cleaning:wash (oneself).V	To cleanse one's body in/with water.
Cleaning:wash.V	To remove dirt and grime from an object, using water (usually with soap).
Cleaning:wipe.V	To move an object or utensil over a surface or other object while maintaining contact, in order that a substance be removed from its surface.
Cleaning:wring.V	To take a cloth and twist its ends into different directions in order to dry it.
Clothing:apron.N	A piece of cloth or plastic, worn over the front of the clothes for protection against dirt.
Clothing:awl.N	Pointed tool for marking or piercing wood or leather.
Clothing:baby sling.N	A piece of cloth used for carrying an infant or small child around a carer's body.
Clothing:bamboo hat.N	A hat made of bamboo (ÊñóÁ¨† d«íul√¨).
Clothing:barefoot.A	Not wearing anything on the feet.
Clothing:bead.N	A hard, rounded object produced within the soft tissue (specifically the mantle) of a living shelled mollusk.
Clothing:belt.N	A clothing accessory, usually made of leather or heavy cloth, worn around the waist and used to support trousers or other articles of clothing.
Clothing:blouse.N	
Clothing:boot.N	A shoe that covers part of the leg.
Clothing:boubou.N	A flowing wide sleeved robe worn by men in much of West Africa, and to a lesser extent in North Africa.
Clothing:braid.N	A hair style formed by interweaving three or more strands of hair.
Clothing:button.N	A fastener consisting of a knob or disc that is passed through a slit in the adjacent material.
Clothing:cap.N	A usually soft and close-fitting head covering, either having no brim or with a visor.
Clothing:cloak.N	A long outer garment worn over the shoulders covering the back; a cape, often with a hood.
Clothing:cloth.N	A woven fabric such as used in dressing, decorating, cleaning or other practical use.
Clothing:clothes.N	All coverings designed to be worn on a person's body.
Clothing:coat.N	A heavy outer garment covering the upper torso and arms.
Clothing:collar.N	The part of a garment that encircles the neck.
Clothing:cushma.N	A one-piece dress used by the Ashaninka Indians.
Clothing:dress up.V	To clothe oneself; to put on clothes.
Clothing:dress.N	A one-piece garment for a woman that has a skirt and a body section.
Clothing:dye.V	To modify the color of something by applying dye.
Clothing:fashion.N	A style of clothing typical to a certain period of time.
Clothing:felt.N	A cloth or stuff made of matted fibres of wool, or wool and fur, fulled or wrought into a compact substance by rolling and pressure, with lees or size, without spinning or weaving.
Clothing:fit.V	(Of an object) To be of the right size and shape so as to match another object.
Clothing:garment.N	An item of clothing.
Clothing:glove.N	A garment for a hand, often extending to the wrist and sometimes up to the elbow, which either covers each finger individually, or separates the thumb from the other fingers.
Clothing:Gossypium.N	Fiber obtained from plants of the genus Gossypium, used in making fabrics, cordage, and padding and for producing artificial fibers and cellulose.
Clothing:grass-skirt.N	A skirt made from long dried grass, or synthetic material resembling it.
Clothing:handkerchief.N	A piece of cloth, usually square and often fine and elegant, carried for wiping the face, nose or hands.
Clothing:harness.N	harness
Clothing:hat.N	An item of clothing intended to cover the head made from material hard enough to have a shape independant of the skull, and most commonly with a rim.
Clothing:headband or headdress.N	An cloth or strip of cloth worn on or around the head.
Clothing:headband.N	A strip of fabric worn around the head, or a hair-accessory made of a flexible material and curved like a horseshoe, for holding one's hair back.
Clothing:headdress.N	A decorative covering or ornament worn on the head.
Clothing:headgear.N	Any element of clothing which is worn on one's head.
Clothing:hemp cloth.N	A woven fabric such as used in dressing, decorating, cleaning or other practical use which is made from hemp.
Clothing:iron.V	To make clothes smooth by brushing over them with a heated tool.
Clothing:jacket.N	A mid-stomach‚Äìlength garment for the upper body.
Clothing:jeans.N	Trousers that are made of denim.
Clothing:knit.V	To create a textile by manipulating yarn with the help of two long needles.
Clothing:leather.N	The dressed or tanned hide of an animal, usually with the hair removed.
Clothing:leg band.N	
Clothing:linen.N	A material made from the fibers of the flax plant.
Clothing:loincloth.N	A cloth worn to cover the loins.
Clothing:loom.N	A frame or machine (made of wood or other material) in which a weaver forms cloth out of thread; a machine for interweaving yarn or threads into a fabric.
Clothing:mask.N	A cover, or partial cover, for the face, used for disguise or protection.
Clothing:moccasin.N	A shoe with a soft sole made from animal skin or leather.
Clothing:naked.A	Without clothing.
Clothing:necktie.N	A small band of fabric which is tied around the collar of a shirt.
Clothing:needle.N	A thin, sharp implement used in sewing, knitting and acupuncture.
Clothing:pacifier.N	An artificial teat made of rubber, plastic, or silicone put into an infant's mouth to calm it.
Clothing:pelt.N	The hair-covered, dressed pelt of a mammal, used in the making of garments and as trimming or decoration.
Clothing:penis sheath.N	Sheath to cover a penis.
Clothing:pin.N	A small device, made (usually) of drawn-out steel wire with one end sharpened and the other flattened or rounded into a head, used for fastening.
Clothing:plait.N	A flat fold; a doubling, as of cloth; a pleat.
Clothing:pocket.N	A kind of pouch, which is accessible by an opening in an article of clothing and serves for storage; usually large enough in order to accommodate at least one hand.
Clothing:poncho.N	A simple garment, made from a rectangle of cloth, with a slit in the middle for the head.
Clothing:put on.V	To put clothes onto ones body to wear them.
Clothing:quilt.V	To stitch or sew together.
Clothing:rag.N	A piece of old cloth; a tattered piece of cloth; a shred, a tatter.
Clothing:raincoat.N	A long jacket which is waterproof.
Clothing:sandal.N	An open type of outdoor footwear leaving most of the upper part of the foot exposed, particularly the toes.
Clothing:sarong.N	A sarong or sarung is a large tube or length of fabric, often wrapped around the waist and worn by men and women throughout much of South Asia.
Clothing:scarf or turban.N	A garment, usually consisting of a long piece of cloth, wound around the head or neck or shoulders.
Clothing:sew.V	To pass thread repeatedly through fabric or a material, using a needle, in order to join two or more parts or to make a pattern or motif.
Clothing:shawl.N	A garment which is wrapped around the neck to prevent from cold.
Clothing:shirt.N	An article of clothing that is worn on the upper part of the body, and often has sleeves, either long or short, that cover the arms.
Clothing:shoe.N	A protective covering for the foot, with a bottom part composed of thick leather or plastic sole and often a thicker heel, and a softer upper part made of leather or synthetic material. Shoes generally do not extend above the ankle, as opposed to boots, which do.
Clothing:shoemaker.N	A person whose profession is making and repairing footwear.
Clothing:shorts.N	Outer pants extending no lower than knees.
Clothing:shuttle.N	Device used in weaving to carry the weft, moving continuously to-and-fro.
Clothing:silk.N	One of the finest textiles, obtained from cocoons of certain species of caterpillars; it is soft, very strong and absorbent and has a brilliant sheen.
Clothing:skirt.N	An article of clothing, usually worn by women and girls, that hangs from the waist and covers the lower part of the body.
Clothing:sleeve.N	Part of a garment covering the arm.
Clothing:slipper.N	A lightweight shoe worn indoors.
Clothing:snowshoe.N	Footwear for walking over the snow.
Clothing:sock.N	A knitted or woven covering for the foot, reaching no higher than just above the ankle.
Clothing:spin.V	To make (yarn) by drawing out, twisting, and winding fibers.
Clothing:spindle.N	A stick used in spinning fiber into thread.
Clothing:stocking.N	A soft garment worn on the foot and lower leg, usually knit or woven, worn under shoes or other footwear.
Clothing:straw raincoat.N	A traditional East Asian garment made out of straw, worn against the rain. In Japanese it's called mino.
Clothing:suit.N	suit (combo of jacket, dress shirt, slacks, and usually necktie)
Clothing:sunglasses.N	Form of glasses with tinted lenses to protect one's eyes from sunlight.
Clothing:T-shirt.N	T-shirt (a collarless short-sleeved casual shirt or undershirt)
Clothing:tailor.N	Someone who professionally manufactures clothing.
Clothing:take off one's clothes.V	Take off one's clothes.
Clothing:take off.V	To take off a piece of clothing or similar.
Clothing:thong.N	A thong underwear or swimsuit, a narrow piece of cloth, leather, or plastic, that covers or holds the genitals, passes between the buttocks, and is attached to a band around the hips.
Clothing:thread.N	A long, thin and flexible form of material, generally with a round cross-section, used in sewing, weaving or in the construction of string.
Clothing:towel.N	Piece of absorbent fabric or paper used for drying or wiping.
Clothing:trousers.N	An item of clothing worn on the lower part of the body and covering both legs separately.
Clothing:umbrella.N	Portable folding canopy used for protection against weather influences.
Clothing:underpants.N	underpants
Clothing:undress.V	To take off all of one's clothes, or to take off a piece of clothing or similar.
Clothing:uniform.N	Special garments worn by members of a group.
Clothing:veil.N	A head covering.
Clothing:vest.N	A piece of clothing for the upper body without sleeves and usually worn over a shirt.
Clothing:wear (on head).V	Wear an object for shelter on the head.
Clothing:wear.V	Fix clothes on your body and carry them.
Clothing:weave.V	To create a fabric by interlacing threads.
Clothing:wrapper.N	A colorful women's garment widely worn in West Africa.
Clothing:yarn.N	Consists of multiple strings of natural or synthetic fibre twisted together in a continuous bulky thread; used in textile production.
Cognition:exact.A	Without diversion from the desired or agreed specification; neither exceeding nor failling short in any way.
Cognition:expect.V	expect, anticipate (believe that X will come/happen) 
Cognition:false.A	Not concurring with a given set of facts; fake; unreal.
Cognition:familiar.A	Knowing somebody or something well.
Cognition:study.N	
Cognition:study.V	To follow a course of study; to be enrolled at an institute of learning.
Cognition:true.A	Concurring with a given set of facts.
Cognition:truth.N	That which conforms to reality.
Cognition:untruth.N	A false statement made with the intention to deceive.
Combat:battle cry.N	A shout, used by warriors in battle with the purpose of arousing aggression on their own side or intimidating the enemy.
Combat:bomb.N	A device filled with explosives used for destroying things.
Combat:box.V	The act of using fists to fight or hit.
Combat:brawl.N	A normally unarmed and ruleless scuffle.
Combat:brawl.V	To be involved in a normally unarmed and ruleless scuffle.
Combat:fight.N	A hostile encounter, such as a battle or combat.
Combat:fight.V	To be involved in a physical confrontation.
Combat:helmet.N	Any of various forms of protective head covering worn e.g.  by soldiers, firefighters, divers, cyclists, etc.
Combat:strike (sb).V	To intentionally hit someone with a sharp blow or to impel, usually with a hand or weapon.
Combat:suit of armour.N	A specific suit that protects people who fight.
Combat:violence.N	The intentional use of physical force or power against oneself, another person, or against a group with the intention of resulting in injury, death, psychological harm, maldevelopment, or deprivation.
Combat:win.V	To achieve a victory.
Combat:wrestle.V	wrestle 
Combat.warship.N	
Communication:accept	To take or get something that was offered by someone, to willingly receive
Communication:answer.V	To communicate a message of any form in reaction to something that has been asked or expressed, to the being who expressed it; to react verbally.
Communication:boast.V	To show off.
Communication:call.V	To address or summon someone.
Communication:cellphone.N	cellphone, cellular telephone
Communication:chat.V	To have a conversation with somebody.
Communication:complain.V	To express one's dissatisfaction or unhappiness.
Communication:deny.V	To refuse strongly and solemnly to own or acknowledge.
Communication:dialect.N	A variety of a language that is characteristic of a particular group.
Communication:email.N	Messages sent and received via computer.
Communication:fairy tale.N	A fairy tale is a type of short story that typically features folkloric fantasy characters, such as dwarves, dragons, elves, fairies, giants, gnomes, goblins, griffins, mermaids, talking animals, trolls, unicorns, or witches, and usually magic or enchantments.
Communication:flirt.V	To talk or behave amorously, without serious intentions.
Communication:forbid.V	To tell not to do something.
Communication:forgive.V	To stop blaming someone for an offense.
Communication:gesture.V	gesture 
Communication:goodbye.N	A conventional expression, used as a farewell when parting.
Communication:goodbye.V	To say goodbye.
Communication:greet.V	To welcome someone; to address someone in a friendly and welcoming way upon meeting them.
Communication:hello.N	A conventional expression, used as a greeting.
Communication:hieroglyph.N	The hieroglyph or hieroglyphics.
Communication:joke.N	Something that is said or done in a non-serious, comic way.
Communication:kiss.N	The action of touching with the lips to express love or affection.
Communication:kiss.V	To touch with the lips to express love or affection.
Communication:language.N	A system of communication using the spoken or signed word or using symbols that represent words, signs or sounds.
Communication:laugh.V	To express pleasure, mirth or derision by peculiar movement of the muscles of the face, particularly of the mouth, causing a lighting up of the face and eyes, and usually accompanied by the emission of explosive or chuckling sounds from the chest and throat.
Communication:laughter.N	Laughter is a physical reaction in humans and some other species of primate, consisting typically of rhythmical, often audible contractions of the diaphragm and other parts of the respiratory system.
Communication:letter.N	A text that is written to and for a specific person or set of people (and is most commonly sent to them by post).
Communication:lie.N	Intentionally false statement for the purpose of deception.
Communication:lie.V	To knowingly say something that is untrue.
Communication:mail.N	A batch of letters and parcels received via post.
Communication:newspaper.N	A publication (usually published daily or weekly and printed on cheap, low-quality paper) that contains news and other articles.
Communication:offer.V	offer (present for acceptance or rejection) 
Communication:phone.V	To communicate by means of a telephone.
Communication:postage stamp.N	A piece of paper that is affixed to letters or packages to pay for their delivery.
Communication:postcard.N	A rectangular piece of thick paper or thin cardboard intended to be written on and mailed without an envelope.
Communication:postman.N	Person who transports and delivers items sent with a postal service.
Communication:praise.V	praise, compliment, laud 
Communication:radio.N	A device that can capture the signal sent over radio waves and render the modulated signal as sound.
Communication:refuse.V	To not do what is being asked.
Communication:scroll.N	A roll of papyrus.
Communication:spell.V	To list the letters of a word.
Communication:talk.V	To converse with one or more persons.
Communication:telephone.N	An electronic device used for calling people.
Communication:television set.N	A device for receiving television signals and displaying them in visual form.
Communication:tell.V	To talk about a story giving its details; to give a detailed account of.
Communication:thank.V	To express one's gratitude.
Communication:thanks.INT	Expression of gratitude.
Communication:translate.V	To communicate of the meaning of a source-language text by means of an equivalent target-language text.
Communication:type.V	Using keys of a computer or typewriter.
Communication:watch (TV).V	The act of watching television.
Communiction:call.N	An act of calling with the voice.
Contact:slap.N	A hit with something flat, usually the open palm of the hand.
Contact:slap.V	Hit with something flat, usually the open palm of the hand.
Cosmos:full moon.N	The lunar phase when the moon is fully illuminated by the sun and appears in the sky as a full circle.
Cosmos:Milky Way.N	The galaxy that contains our Solar System. Its name milky is derived from its appearance as a dim glowing band arching across the night sky in which the naked eye cannot distinguish individual stars.
Cosmos:moon.N	A natural satellite of a planet.
Cosmos:new moon.N	The lunar phase when the moon appears in the sky as a slender crescent shortly after its conjunction with the sun.
Cosmos:Orion.N	A constellation of stars visible from around the world.
Cosmos:Orion‚Äôs Belt.N	A pattern of three stars in the constellation Orion.
Cosmos:planet.N	planet
Cosmos:Polaris.N	Referring to Polaris or Alpha Ursae Minoris, a star aligned with earth‚Äôs axis of rotation and often used for navigation.
Cosmos:set.V	[Of a heavenly body, essentially the Sun and the Moon] To disappear below the horizon of a planet or another heavenly body (most often the Earth).
Cosmos:shooting star.N	Name for the visible path of a meteoroid.
Cosmos:star.N	A luminous celestial body that is made from gases (particularly hydrogen and helium) and forms the shape of a sphere.
Cosmos:starlight.N	Light emitted by stars.
Cosmos:Sun.N	The particular star at the centre of our solar system, from which the Earth gets light and heat.
Cosmos:universe.N	universe
Cosmos:Ursa major.N	A large group of stars in the shape of a bear visible on the northern hemisphere.
Cosmos:waning moon.N	The phase in the lunar cycle between full moon and new moon when the illuminated area decreases.
Cosmos:waxing moon.N	The phase in the lunar cycle between new moon and full moon when the illuminated area increases.
Education:university.N	A university (Latin: universitas, a whole) is an institution of higher (or tertiary) education and research which grants academic degrees in various subjects and typically provides undergraduate education and postgraduate education.
Element:Ac.N	Actinium, the chemical element with atomic number 89 and symbol Ac.
Element:Ag.N	A very ductile malleable brilliant greyish-white element with symbol Ar and atomic number 47 having the highest electrical and thermal conductivity of any metal.
Element:Al.N	A metallic chemical element of silver-white colour that occurs mainly in bauxite, with assigned symbol Al and proton number 13.
Element:Am.N	Americium, the chemical element with atomic number 95 and symbol Am.
Element:Ar.N	Argon, the chemical element with atomic number 18 and symbol Ar.
Element:As.N	Arsenic, the chemical element with atomic number 33 and symbol As.
Element:As.N	Astatine, the chemical element with atomic number 85 and symbol As.
Element:Au.N	A heavy yellow elemental metal of great value, with atomic number 79 and symbol Au.
Element:B.N	Boron, the chemical element with atomic number 5 and symbol B.
Element:Ba.N	Barium, the chemical element with atomic number 56 and symbol Ba.
Element:Be.N	Beryllium, the chemical element with atomic number 4 and symbol Be.
Element:Bh.N	Bohrium, the chemical element with atomic number 107 and symbol Bh.
Element:Bi.N	Bismuth, the chemical element with atomic number 83 and symbol Bi.
Element:Bk.N	Berkelium, the chemical element with atomic number 97 and symbol Bk.
Element:Br.N	Bromine, the chemical element with atomic number 35 and symbol Br.
Element:C.N	Carbon (Coal), the chemical element with atomic number 6 and symbol C.
Element:Ca.N	Calcium (Ca), the chemical element with atomic number 20 and symbol Ca.
Element:Cd.N	Cadmium, the chemical element with atomic number 48 and symbol Cd.
Element:Ce.N	Cerium, the chemical element with atomic number 58 and symbol Ce.
Element:Cf.N	Californium, the chemical element with atomic number 98 and symbol Cf.
Element:Cl.N	Chlorine, the chemical element with atomic number 17 and symbol Cl.
Element:Cm.N	Curium, the chemical element with atomic number 96 and symbol Cm.
Element:Cn.N	Copernicium, the chemical element with atomic number 112 and symbol Cn.
Element:Co.N	Cobalt, the chemical element with atomic number 27 and symbol Co.
Element:Cr.N	Chromium, the chemical element with atomic number 24 and symbol Cr.
Element:Cs.N	Caesium, the chemical element with atomic number 55 and symbol Cs.
Element:Cu.N	Chemical element with symbol Cu and atomic number 29; one of the most important nonferrous metals; a ductile and malleable metal found in various ores and used in industry, engineering, and the arts in both pure and alloyed form.
Element:Db.N	Dubnium, the chemical element with atomic number 105 and symbol Db.
Element:Ds.N	Darmstadtium, the chemical element with atomic number 110 and symbol Ds.
Element:Dy.N	Dysprosium, the chemical element with atomic number 66 and symbol Dy.
Element:Er.N	Erbium, the chemical element with atomic number 68 and symbol Er.
Element:Es.N	Einsteinium, the chemical element with atomic number 99 and symbol Es.
Element:Eu.N	Europium, the chemical element with atomic number 63 and symbol Eu.
Element:F.N	Fluorine, the chemical element with atomic number 9 and symbol F.
Element:Fe.N	A malleable ductile silvery-white ferromagnetic metallic element with symbol Fe and atomic number 26, occurring principally in haematite and magnetite. It is widely used for structural and engineering purposes.
Element:Fl.N	Flerovium, the chemical element with atomic number 114 and symbol Fl.
Element:Fm.N	Fermium, the chemical element with atomic number 100 and symbol Fm.
Element:Fr.N	Francium, the chemical element with atomic number 87 and symbol Fr.
Element:Ga.N	Gallium, the chemical element with atomic number 31 and symbol Ga.
Element:Gd.N	Gadolinium, the chemical element with atomic number 64 and symbol Gd.
Element:Ge.N	Germanium, the chemical element with atomic number 32 and symbol Ge.
Element:H.N	Hydrogen, the chemical element with atomic number 1 and symbol H.
Element:He.N	Helium, the chemical element with atomic number 2 and symbol He.
Element:Hf.N	Hafnium, the chemical element with atomic number 72 and symbol Hf.
Element:Hg.N	Mercury (Quicksilver), the chemical element with atomic number 80 and symbol Hg.
Element:Ho.N	Holmium, the chemical element with atomic number 67 and symbol Ho.
Element:Hs.N	Hassium, the chemical element with atomic number 108 and symbol Hs.
Element:I.N	Iodine, the chemical element with atomic number 53 and symbol I.
Element:In.N	Indium, the chemical element with atomic number 49 and symbol In.
Element:Ir.N	Iridium, the chemical element with atomic number 77 and symbol Ir.
Element:K.N	Potassium, the chemical element with atomic number 19 and symbol K.
Element:Kr.N	Krypton, the chemical element with atomic number 36 and symbol Kr.
Element:La.N	Lanthanum, the chemical element with atomic number 57 and symbol La.
Element:Li.N	Lithium, the chemical element with atomic number 3 and symbol Li.
Element:Lr.N	Lawrencium, the chemical element with atomic number 103 and symbol Lr.
Element:Lu.N	Lutetium, the chemical element with atomic number 71 and symbol Lu.
Element:Lv.N	Livermorium, the chemical element with atomic number 116 and symbol Lv.
Element:Mc.N	Moscovium, the chemical element with atomic number 115 and symbol Mc.
Element:Md.N	Mendelevium, the chemical element with atomic number 101 and symbol Md.
Element:Mg.N	Magnesium, the chemical element with atomic number 12 and symbol Mg.
Element:Mn.N	Manganese, the chemical element with atomic number 25 and symbol Mn.
Element:Mo.N	Molybdenum, the chemical element with atomic number 42 and symbol Mo.
Element:Mt.N	Meitnerium, the chemical element with atomic number 109 and symbol Mt.
Element:N.N	Nitrogen, the chemical element with atomic number 7 and symbol N.
Element:Na.N	Sodium, the chemical element with atomic number 11 and symbol Na.
Element:Nb.N	Niobium, the chemical element with atomic number 41 and symbol Nb.
Element:Nd.N	Neodymium, the chemical element with atomic number 60 and symbol Nd.
Element:Ne.N	Neon, the chemical element with atomic number 10 and symbol Ne.
Element:Nh.N	Nihonium, the chemical element with atomic number 113 and symbol Nh.
Element:Ni.N	Nickel, the chemical element with atomic number 28 and symbol Ni.
Element:No.N	Nobelium, the chemical element with atomic number 102 and symbol No.
Element:Np.N	Neptunium, the chemical element with atomic number 93 and symbol Np.
Element:O.N	Oxygen, the chemical element with atomic number 8 and symbol O.
Element:Og.N	Oganesson, the chemical element with atomic number 118 and symbol Og.
Element:Os.N	Osmium, the chemical element with atomic number 76 and symbol Os.
Element:P.N	Phosphorus, the chemical element with atomic number 15 and symbol P.
Element:Pa.N	Protactinium, the chemical element with atomic number 91 and symbol Pa.
Element:Pb.N	A heavy toxic bluish-white metallic element with symbol Pb and atomic number 82 that is highly malleable; occurs principally as galena and is used in alloys, accumulators, cable sheaths, paints, and as a radiation shield.
Element:Pd.N	Palladium, the chemical element with atomic number 46 and symbol Pd.
Element:Pm.N	Promethium, the chemical element with atomic number 61 and symbol Pm.
Element:Po.N	Polonium, the chemical element with atomic number 84 and symbol Po.
Element:Pr.N	Praseodymium, the chemical element with atomic number 59 and symbol Pr.
Element:Pt.N	Platinum, the chemical element with atomic number 78 and symbol Pt.
Element:Pu.N	Plutonium, the chemical element with atomic number 94 and symbol Pu.
Element:Ra.N	Radium, the chemical element with atomic number 88 and symbol Ra.
Element:Rb.N	Rubidium, the chemical element with atomic number 37 and symbol Rb.
Element:Re.N	Rhenium, the chemical element with atomic number 75 and symbol Re.
Element:Rf.N	Rutherfordium, the chemical element with atomic number 104 and symbol Rf.
Element:Rg.N	Roentgenium, the chemical element with atomic number 111 and symbol Rg.
Element:Rh.N	Rhodium, the chemical element with atomic number 45 and symbol Rh.
Element:Rn.N	Radon, the chemical element with atomic number 86 and symbol Rn.
Element:Ru.N	Ruthenium, the chemical element with atomic number 44 and symbol Ru.
Element:S.N	Sulfur (Brimstone), the chemical element with atomic number 16 and symbol S.
Element:Sb.N	Antimony, the chemical element with atomic number 51 and symbol Sb.
Element:Sc.N	Scandium, the chemical element with atomic number 21 and symbol Sc.
Element:Se.N	Selenium, the chemical element with atomic number 34 and symbol Se.
Element:Sg.N	Seaborgium, the chemical element with atomic number 106 and symbol Sg.
Element:Si.N	Silicon, the chemical element with atomic number 14 and symbol Si.
Element:Sm.N	Samarium, the chemical element with atomic number 62 and symbol Sm.
Element:Sn.N	Tin, the chemical element with atomic number 50 and symbol Sn.
Element:Sr.N	Strontium, the chemical element with atomic number 38 and symbol Sr.
Element:Ta.N	Tantalum, the chemical element with atomic number 73 and symbol Ta.
Element:Tb.N	Terbium, the chemical element with atomic number 65 and symbol Tb.
Element:Tc.N	Technetium, the chemical element with atomic number 43 and symbol Tc.
Element:Te.N	Tellurium, the chemical element with atomic number 52 and symbol Te.
Element:Th.N	Thorium, the chemical element with atomic number 90 and symbol Th.
Element:Ti.N	Titanium, the chemical element with atomic number 22 and symbol Ti.
Element:Tl.N	Thallium, the chemical element with atomic number 81 and symbol Tl.
Element:Tm.N	Thulium, the chemical element with atomic number 69 and symbol Tm.
Element:Ts.N	Tennessine, the chemical element with atomic number 117 and symbol Ts.
Element:U.N	Uranium, the chemical element with atomic number 92 and symbol U.
Element:V.N	Vanadium, the chemical element with atomic number 23 and symbol V.
Element:W.N	Tungsten (Wolfram), the chemical element with atomic number 74 and symbol W.
Element:Xe.N	Xenon, the chemical element with atomic number 54 and symbol Xe.
Element:Y.N	Yttrium, the chemical element with atomic number 39 and symbol Y.
Element:Yb.N	Ytterbium, the chemical element with atomic number 70 and symbol Yb.
Element:Zn.N	Zinc, the chemical element with atomic number 30 and symbol Zn.
Element:Zr.N	Zirconium, the chemical element with atomic number 40 and symbol Zr.
Emotion:afraid.A	Property of being scared of something or someone, having an uncontrollable emotion of anxiety.
Emotion:amazing.A	Causing great surprise or sudden wonder.
Emotion:amusement.N	A feeling caused by doing or watching something entertaining or funny.
Emotion:anger.N	Belligerence aroused by a real or supposed wrong (personified as one of the deadly sins).
Emotion:angry.A	Irritated, in a temper, feeling or displaying anger.
Emotion:anxiety.N	An unpleasant complex combination of emotions that includes fear, apprehension and worry, and is often accompanied by physical sensations such as palpitations, nausea, chest pain and/or shortness of breath.
Emotion:anxious.A	To feel uneasiness of mind caused by anxiety.
Emotion:ashamed.A	Feeling shame or guilt.
Emotion:astonished.A	Filled with the emotional impact of overwhelming surprise or shock.
Emotion:awe.N	A feeling of deep respect mixed with slight fear or wonder.
Emotion:bad or evil.A	Not good; unfavorable; negative, or intending to harm or being/acting ethically wrong.
Emotion:bad.A	Not good; unfavorable; negative.
Emotion:be angry.V	Be in an angry state.
Emotion:be ashamed.V	
Emotion:be glad.V	
Emotion:become angry.V	To turn into an angry mental state.
Emotion:blame.N	Accusation for something negative or undesirable.
Emotion:blame.V	To hold somebody responsible for something.
Emotion:boring.A	Causing boredom.
Emotion:comfort.N	comfort (freedom from pain and/or worry)
Emotion:contempt.N	A feeling of ultimate disgust and a complete lack of respect towards somebody.
Emotion:contemptible.A	Deserving of contempt or scorn.
Emotion:courage.N	A state or quality of mind that enables to face danger and fear; bravery.
Emotion:courageous.A	Having or characterized by courage.
Emotion:coward.N	A person who lacks courage.
Emotion:cowardly.A	Not being brave or courageous; an attribute describing someone who is easily frightened or disheartened in the face of difficulty or danger.
Emotion:cruel.A	Indifference towards the suffering of another and even deriving a positive feeling from it.
Emotion:cry.V	To shed tears due to the impact of an emotion.
Emotion:curious.A	Having a strong desire to learn about things and people around.
Emotion:dare.V	To have enough courage (to do something).
Emotion:delight.V	To give pleasure to; to make happy or satisfied.
Emotion:depressed.A	A mental state of despondency, unhappinness, or hopelessness.
Emotion:depression.N	A state of feeling sad that can become a chronic illness.
Emotion:disappointment.N	A feeling of sadness because something did not happen the way it was expected or did not happen at all.
Emotion:emotional.A	Having any strong feeling, as of joy, sorrow, or fear.
Emotion:enthuse.V	
Emotion:envy.N	A feeling of discontent or covetousness with regard to another's advantages, success, possessions, etc.
Emotion:evil.A	Intending to harm or being/acting ethically wrong.
Emotion:excited.A	Arousal or a feeling of enthusiasm about something.
Emotion:excitement.N	A feeling of extreme but short-term happiness.
Emotion:fear or frighten.V	To be scared or to scare someone.
Emotion:fear.N	An emotion experienced in anticipation of some specific pain or danger.
Emotion:fear.V	To be scared of; to have an uncontrollable emotion of anxiety about something that causes a scared reaction or frightening impression.
Emotion:feel.V	To sense things mentally (pain, joy, etc.) or to be in some emotional state.
Emotion:feeling.N	Sensing things mentally (pain, joy, etc.).
Emotion:frighten.V	To make someone afraid or anxious.
Emotion:gentle.A	Tender and amiable; of a considerate or kindly disposition.
Emotion:gloomy.A	A bit sad.
Emotion:grief.N	Mental suffering or pain caused by injury, loss, or despair.
Emotion:grief.V	To express deep sorrow for.
Emotion:happiness.N	In philosophy, happiness translates the Greek concept of eudaimonia, and refers to the good life, or flourishing, rather than simply an emotion.
Emotion:happy.A	Having a feeling of satisfaction, enjoyment or well-being, often arising from a positive situation or set of circumstances.
Emotion:hate.N	A strong feeling of dislike for something or somebody.
Emotion:hate.V	To dislike intensely; to feel strong hostility towards.
Emotion:hope or hoping.V	To want something to happen or the belief in the possibility that something one wants will happen.
Emotion:hope.N	The belief in the possibility that something one wants will happen.
Emotion:hope.V	To want something to happen.
Emotion:impatient.A	Becoming irritable in difficult situations or during long waiting times.
Emotion:jealous.A	Feeling insecure over an anticipated loss of status or affection in a human connection.
Emotion:jealousy.N	A jealous feeling, disposition, state, or mood.
Emotion:kind.A	Being nice and giving off the impression of benevolence.
Emotion:kindness.N	The quality of being caring, generous and helpful towards other people.
Emotion:like.V	To enjoy, be in favor/favour of.
Emotion:long for.V	To have a very strong desire for something.
Emotion:longing.N	The strong desire for something.
Emotion:look forward.V	
Emotion:love.N	A feeling of affection and fondness for someone.
Emotion:love.V	To have an intense feeling of affection and care towards another person.
Emotion:merry.A	In good spirits.
Emotion:miss.V	To long to see somebody again.
Emotion:mood.N	
Emotion:mourning.N	The feeling of great sadness because someone has died.
Emotion:move.V	To affect somebody emotionally.
Emotion:on purpose.ADV	(Doing or feeling something) in a deliberate or controlled way.
Emotion:respect.N	An attitude of admiration or esteem.
Emotion:respect.V	To have respect for someone or something; to have regard for something, to observe a custom, practice, rule or right.
Emotion:sad.A	Feeling mentally uncomfortable because something is missing or wrong.
Emotion:sadness.N	A feeling of being unhappy because something is missing or wrong.
Emotion:shame.N	The consciousness or awareness of dishonor, disgrace, or condemnation.
Emotion:shy or ashamed.A	The feeling of being uncomfortable with attracting attention or feeling shame or guilt.
Emotion:shy.A	(For a personality) characterized by being uncomfortable with having attention drawn to them, for example when introducing oneself or when speaking in front of an audience.
Emotion:surprise.N	A feeling caused by something unexpected.
Emotion:surprise.V	To make someone feel surprised by giving, telling or doing something unexpected.
Emotion:surprised.A	Feeling that something unexpected has happened.
Emotion:triumph.N	A feeling of extreme pleasure and excitement as a result of success or a victory.
Emotion:unhappy.A	Feeling not cheerful or glad, sometimes due to a misfortune.
Emotion:unpleasant.A	Not to one's liking.
Emotion:want.V	To want to do something or to wish for something to happen.
Emotion:worry.V	To be anxious about something.
Family:ancestors.N	Person from whom a person is descended, whether on the father's or mother's side, at any number of generations.
Family:aunt or uncle.N	The brother or mother of someone‚Äôs father or mother.
Family:aunt.N	A woman with one or more siblings who have one or more children; a sister of someone's father or mother.
Family:bride.N	A woman who is going to get married or has just got married.
Family:brother.N	A male person who has the same parents as another person.
Family:child-in-law.N	The spouse of someone's child.
Family:child.N	Biological offspring.
Family:co-father-in-law.N	The father-in-law of ego‚Äôs child.
Family:co-mother-in-law.N	The mother-in-law of ego‚Äôs child.
Family:co-wife.N	Another female partner in a polygamous marriage.
Family:cousin.N	The child of the sibling of a parent of a person.
Family:daughter.N	An animal's female offspring (including that of a human).
Family:descendant.N	One who is the progeny of someone at any distance of time.
Family:divorce.N	Legal dissolution of a marriage.
Family:divorce.V	To end one's marriage by a legal process.
Family:family name.N	The family name of a person.
Family:family.N	A group comprising parents, offsprings and others closely related or associated with them.
Family:father-in-law.N	The father of someone's spouse.
Family:father.N	A male parent.
Family:grandchild.N	A child of someone‚Äôs child.
Family:granddaughter.N	A daughter of someone's child.
Family:grandfather.N	The father of one of someone's parents.
Family:grandmother.N	The mother of one of someone's parents.
Family:grandparent.N	Either the grandfather or the grandmother.
Family:grandparents.N	The parents of someone's parent.
Family:grandson.N	A son of someone's child.
Family:groom.N	A man who is going to get married or has just married.
Family:husband.N	The male partner in a marriage.
Family:marriage or wedding.N	The ceremony of marrying someone or the state of being married.
Family:marriage.N	Marriage, also called matrimony or wedlock, is a socially or ritually recognized union or legal contract between spouses that establishes rights and obligations between them, between them and their children, and between them and their in-laws.
Family:married man.N	A married man.
Family:married woman.N	A married woman.
Family:marry off.V	To force someone to get married, usually a relative.
Family:marry.V	To enter marriage; to take a husband or a wife.
Family:mother-in-law.N	The mother of someone's spouse.
Family:mother.N	A woman who has at least one child.
Family:nephew or niece.N	A child of someone's brother or sister.
Family:nephew.N	A son of someone's brother or sister.
Family:niece.N	A daughter of someone‚Äôs brother or sister.
Family:older brother.N	A male with more years of age than one or more of his siblings.
Family:older sibling.N	A person who is born before another person who has the same parents.
Family:older sister.N	A female with more years of age than one or more of her siblings.
Family:orphan.N	A person one or both of whose parents have died, especially a minor.
Family:parents.N	Father and mother of a child.
Family:relatives.N	A person that is considered to be of the same family due to shared ancestors, marriage or adoption.
Family:sibling-in-law.N	The husband of one's sister.
Family:sibling.N	A person who has the same parents as another person.
Family:sister.N	A female person who has the same parents as another person.
Family:son.N	One's male child.
Family:spouse.N	One of the partners in a marriage, be they male or female.
Family:step-.A	
Family:stepchild.N	The child of one's spouse and his or her previous partner.
Family:stepdaughter.N	The daughter of one's spouse and his or her previous partner.
Family:stepfather.N	The husband of one's biological mother, other than one's biological father.
Family:stepmother.N	The wife of one's biological father, other than one's biological mother.
Family:stepson.N	The son of one's spouse and his or her previous partner.
Family:uncle.N	The brother of someone‚Äôs father or mother.
Family:wedding.N	A ceremony celebrating the beginning of a marriage, during which the marrying parties exchanges vows.
Family:widow.N	A woman whose spouse has died.
Family:widower.N	A man whose spouse has died.
Family:wife.N	The female partner in a marriage.
Family:younger brother.N	A male with fewer years of age than one or more of his siblings.
Family:younger sibling.N	A person who is born after another person who has the same parents.
Family:younger sister.N	A female who is younger than one or more of her siblings.
Flower:Prunus armeniaca.N	The flower of the Apricot Tree.
Flower:Prunus salicina.N	The flower of the Chinese Plum.
Food:alcohol.N	A drink (a liquor or brew) containing ethanol, commonly known as alcohol.
Food:bake.V	To cook (something) in an oven, but not in fat, or harden by means of dry heat.
Food:barbecue.V	To cook food on a grill traditionally employing hot charcoal as the heating medium.
Food:cake.N	Cake is a form of sweet dessert that is typically baked.
Food:candy.N	Food item that is rich in sugar.
Food:Citrus sinensis.N	A fruit of the citrus species citrus x sinensis.
Food:cream.N	
Food:dinner.N	A meal that is eaten in the late afternoon or evening daily.
Food:drink.V	drink 
Food:fermented alcohol.N	A fermented drink is a beverage containing alcohol because of a metabolic process that converts sugar to acids, gases and/or alcohol (e.g. beer or wine).
Food:Ficus carica.N	The fruit of the fig tree, pear-shaped and containing many small seeds.
Food:flour.N	Ground or milled grain or cereal.
Food:Glycine max.N	The edible seed of the soybean plant which contains a lot of protein.
Food:griddle.N	A metal or stone flat plate on which food is fried or baked.
Food:main meal.N	The main meal of the day, eaten in the middle of the day or in the evening
Food:Malus domestica.N	The popular, crisp, round fruit of the apple tree, usually with red, yellow or green skin, light-coloured flesh and pips inside.
Food:Metroxylon sagu.N	Starch extracted from the spongy centre, or pith, of various tropical palm stems, especially Metroxylon sagu.
Food:Musa acuminata.N	The fruit of the banana tree.
Food:Musa balbisiana.N	A kind of banana that is normally cooked and not eaten raw.
Food:NaCl.N	A condiment (NaCl - Sodium Chloride) used to add to or enhance the flavour of food (commonly with pepper).
Food:noodle.N	A string or strip of pasta, especially as used in Chinese and Italian cookery.
Food:Prunus armeniaca.N	A fruit of orange color with a fuzzy peel and a black seed inside, similar to a peach or plum of a tree from the family Prunus armeniaca.
Food:salad.N	A food made primarily of a mixture of raw or cold ingredients, typically vegetables, usually served with a dressing such as vinegar or mayonnaise.
Food:sandwich.N	Foodstuff where pieces of bread serve as the wrapper of some other food.
Food:sauce.N	A liquid food accompanying a dish.
Food:sausage.N	A length of intestine, stuffed with ground (organ) meat, and other ingredients. Instead of intestines, a different kind of wrapper can be used.
Food:soup.N	A cooked, liquid dish (made from meat or vegetables that are mixed with broth in a pot) that is often sold in tins.
Food:supper.N	The last meal of the evening.
Food:tea.N	The drink made by infusing dried leaves or buds in hot water.
Form:bend (sth).V	To carry out a movement to turn something into a curved shape.
Form:bend.V	Movement that causes the formation of a curve.
Function:1DU EXCL.PRN	Exclusive dual of the first person: I and exactly one other person, but not the addressed person (you).
Function:1DU INCL.PRN	Inclusive dual of the first person: I and exactly one other person, including the addressed person (you).
Function:1DU.PRN	The speaker and exactly one other person.
Function:1PL EXCL.PRN	Exclusive we: I and at least one other person, but not the addressed person (you) (pronoun 1st person plural without 2nd person).
Function:1PL INCL.PRN	Inclusive we: I and at least one other person, including the addressed person(s) (pronoun 1st person plural with 2nd person).
Function:1PL OBL.PRN	Oblique case of the first person plural pronoun.
Function:1PL.PRN	The speaker or writer and at least one other person.
Function:1SG OBL.PRN	Oblique cases of the first person singular pronoun.
Function:1SG.PRN	The speaker or writer referring to himself or herself alone.
Function:2DU.PRN	The third person dual of the personal pronoun.
Function:2DU.PRN	Addressing two persons (second person dual).
Function:2PL HON.PRN	The group of persons addressed (honorific).
Function:2PL OBL.PRN	The oblique case of the second person plural pronoun.
Function:2PL.PRN	The group of persons addressed.
Function:2SG FRM.PRN	The formal way to address the second person.
Function:2SG HON.PRN	The person addressed (honorific).
Function:2SG OBL.PRN	Oblique cases of the second person singular pronoun.
Function:2SG.PRN	The person addressed.
Function:3PL.PRN	The third person plural of the personal pronoun that designates more than one person or animal, thing or idea which have already been mentioned previously.
Function:3SG INAN.PRN	An inanimate object, an animate object of unspecified sex, or a subject that is previously mentioned.
Function:3SG M.PRN	A male other; the male previously mentioned; himself.  3rd person singular masculine subject pronoun.
Function:3SG N.PRN	Third person singular addressing living things or persons.
Function:3SG.PRN	Third person singular pronoun, regardless of gender/sex.
Function:and or but.CNJ	
Function:and.CNJ	Used to connect two homogeneous words or phrases.
Function:FUT.PTCL	The particle indicating the future tense.
Function:hey.INT	Particle for getting attention of people.
Function:let:PART	The optative particle.
Function:NEG.PTCL	Negative marker.
Function:neither.CNJ	The first word in neither... nor.
Function:nor.CNJ	The second word in neither... nor.
Function:or.CNJ	Conjunction that indicates an alternative.
Function:PRS.PTCL	The particle indicating the present tense.
Function:PST.PTCL	The particle indicating the past tense.
Function:Q.PTCL	The word that is used in the interrogation and indicates doubt
Function:then.CNJ	The second word in if... then.
Grooming:adorned.A	Something that is crested with adornment.
Grooming:adornment.N	Something that beautifies or adorns.
Grooming:armlet.N	A band or bracelet worn round the upper part of a person's arm.
Grooming:bracelet.N	Piece of jewellery worn around the wrist.
Grooming:brush (teeth).V	Clean one's teeth by repeatedly grating over them with an object.
Grooming:brush.N	An implement with a handle, and a head with multiple more or less flexible bristles, used for arranging hair.
Grooming:comb.N	A toothed implement for grooming the hair.
Grooming:comb.V	To groom the hair with a comb or a similar object.
Grooming:decorate.V	To make more attractive by adding ornament, colour, etc.
Grooming:earring.N	A piece of jewelry worn on the ear.
Grooming:file.V	Make something smooth, often nails or other parts of the body.
Grooming:fringe.N	A decorative border.
Grooming:jewel.N	A precious stone such as a diamond, a sapphire or an agate.
Grooming:lipstick.N	Stick containing wax, oil, or pigments used to apply colour to one's lips.
Grooming:mirror.N	A smooth surface, usually made of glass with reflective material painted on the underside, that reflects light so as to give an image of what is in front of it.
Grooming:necklace.N	An article of jewelry that is worn around the neck.
Grooming:ointment.N	A semisolid preparation intended for external application to the skin or mucous membranes. (source: UMLS)
Grooming:ornament.N	An element of decoration.
Grooming:razor.N	A bladed tool used for the removal of body hair through the act of shaving.
Grooming:ring.N	A round piece of (precious) metal worn around the finger.
Grooming:shave.V	To cut the hair close to the skin with a razor.
Grooming:shower.V	Douse oneself in a stream of water in order to clean oneself.
Grooming:soap.N	A cleansing agent, manufactured in bars, granules, flakes, or liquid form, made from a mixture of the sodium salts of various fatty acids of natural oils and fats.
Grooming:tattoo.N	A marking made by inserting ink into the layers of skin to change the pigment permanently for decorative or other reasons.
Grooming:toothbrush.N	A device to brush one's teeth.
Grooming:wreath.N	An assortment of flowers and other things that is constructed to resemble a ring.
Grooming:wristband.N	An article used as an adornment around the wrist
Handiwork:adze.N	A sharp tool with the blade at a right angle to the handle, used to shape pieces of wood.
Handiwork:anvil.N	A heavy iron block used by a blacksmith as a surface upon which metal can be struck and shaped.
Handiwork:axe.N	A tool for felling trees or chopping wood consisting of a heavy metallic or stone head flattened to a blade on one side, and which is attached to a usually wooden handle.
Handiwork:bellows.N	A device that consists of a flexible leather air valve which can be expanded or contracted by operating the two handles, located on the opposite sides. It has many applications, especially blowing on a fire to supply it with air.
Handiwork:blacksmith.N	A craftsman expert in iron and other metals work.
Handiwork:bore.V	To create a hole by removing material with a drill.
Handiwork:bottom grindstone.N	The bottom element in a two-stone grindstone.
Handiwork:braid (verb).V	To braid together hair, threads, strings, twigs etc. in order to create a larger string-like object (which can be linear as in a braid of hair or circular as in a wreath).
Handiwork:braid or weave.V	To braid together hair, threads, strings, twigs etc. in order to create a larger string-like object or to weave a basket or use similar techniques for creating other objects.
Handiwork:carpenter.N	Artisan who works with wood.
Handiwork:carve.V	To cut or to chip in order to form something.
Handiwork:cast.V	To pour [a hardenable liquid material, like metal, plaster, glass, concrete etc.] into a mold in order to produce a solid object of the shape of the mold.
Handiwork:chisel.N	A tool with a cutting edge at the end.
Handiwork:cut (with axe).V	To chop with an axe, e.g. wood in order to use it as firewood.
Handiwork:cut (with knife).V	To slice or to divide into pieces with help of a knife or a knifelike object.
Handiwork:cut (with scissors).V	To divide into pieces with help of scissors, especially things like a rope, a piece of cloth, or a piece of paper.
Handiwork:drill.N	A power tool designed to create holes by means of rotating the drill bits into hard material.
Handiwork:file.N	A hand tool with a long flat metal bar used to re-shape objects.
Handiwork:forge.V	To create and mold by hammering.
Handiwork:glue.V	To stick objects together with adhesive substance.
Handiwork:grate.V	To abrade an object by rubbing it against a rough surface.
Handiwork:grindstone.N	A grindstone is a round sharpening stone used for grinding or sharpening ferrous tools.
Handiwork:hammer.N	A tool with a heavy head and a handle used for pounding.
Handiwork:hammer.V	Strike or beat something with a hammer.
Handiwork:mould.N	A frame or model around or on which something is formed or shaped.
Handiwork:nail.N	A spike-shaped metal fastener used for joining wood or similar materials.
Handiwork:nail.V	To hammer a nail into something.
Handiwork:patch.N	A piece of material used to cover or repair a flaw.
Handiwork:patch.V	To repair a hole in a cloth or wheel.
Handiwork:peg.N	A cylindrical wooden, metal etc. object used to fasten or as a bearing between objects.
Handiwork:pierce.V	To tab something through something else.
Handiwork:plait or braid or weave.V	To add pleats to cloth, to braid together hair, threads, strings, twigs etc. in order to create a larger string-like object or to create a fabric by interlacing threads.
Handiwork:plane.N	A hand tool that is designed to flatten or shape wood.
Handiwork:pocketknife.N	A small knife with one or more blades that fold back into the handle.
Handiwork:polish (something).V	To make something smooth and shiny by rubbing it with a cloth.
Handiwork:potter.N	One who makes pots and other ceramic wares.
Handiwork:repair.V	To restore something by replacing a broken part or putting together what is broken.
Handiwork:saw (something).V	To cut something with a saw.
Handiwork:saw.N	A tool with a toothed blade used for cutting hard substances, in particular wood or metal.
Handiwork:scissors.N	A tool used for cutting thin material, consisting of two crossing blades attached at a pivot point in such a way that the blades slide across each other when the handles are closed.
Handiwork:scraper.N	An instrument with which anything is scraped.
Handiwork:screw.N	A shaft with a helical groove or thread formed on its surface. Its main use is as a threaded fastener used to hold objects together.
Handiwork:screwdriver.N	A hand tool used for driving screws.
Handiwork:sewing machine.N	A machine that partially automates the process of sewing, i.e. uniting pieces of material by using a needle and a thread.
Handiwork:shears.N	A tool consisting of two blades with bevel edges, connected by a pivot, used for cutting cloth, or for removing the fleece from sheep etc.
Handiwork:sieve (tool).N	A device for separating wanted elements from unwanted material.
Handiwork:skilled.A	Experienced and clever, professional.
Handiwork:tool.N	A mechanical device intended to make a task easier.
Handiwork:top grindstone.N	The top (and usually proper) element in a two-stone grindstone.
Handiwork:ware.N	Manufactured articles.
Handiwork:weave (basket).V	To weave a basket or use similar techniques for creating other objects.
Handiwork:weaver.N	A person whose occupation is weaving cloth, carpets, or baskets.
Handiwork:whetstone.N	A stone that is used for whetting a knife or edge tools.
Handiwork:worker.N	Somebody who works.
Handiwork:workshop.N	A room or building in which work, especially mechanical work, is carried on.
Health:become sick.V	To catch a disease.
Health:disease.N	A definite pathological process having a characteristic set of signs and symptoms which are detrimental to the well-being of the individual.
Health:dislocate.V	To (accidentally) dislodge a skeletal bone from its joint.
Health:fever.N	A higher than normal temperature of a person (or generally a mammal).
Health:have a fever.V	Have an increased body temperature.
Health:have diarrhea.V	Suffering from loose or liquid bowel movements.
Health:headache.N	A pain in the head.
Health:healthiness.N	Relating to the general state of health and well-being.
Health:healthy.A	In good physical and mental condition; free from disease.
Health:hospital.N	hospital
Health:hospital.N	A place where people who are ill or injured are treated and taken care of by doctors and nurses.
Health:injection.N	A method of putting liquid into the body with a hollow needle and a syringe which is pierced through the skin long enough for the material to be forced into the body.
Health:leprosy.N	An infectious disease caused by the bacteria Mycobacterium leprae that affects the skin as well as the peripheral nerves.
Health:malaria.N	Infectious disease characterized by chills, fevers, and sweating, caused by a protozoan of the genus Plasmodium and transmitted by infected Anopheles mosquitoes.
Health:measles.N	A contagious airborne disease caused by Measles morbillivirus and characterized by red rash, Koplik's spots, and fever.
Health:medicine.N	A substance which specifically promotes healing.
Health:operate.V	Perform a medical procedure by cutting or making incisions.
Health:patient.N	A person registered as a recipient of medical services.
Health:physician.N	A person who has completed a study of medicine, and as such tries to diagnose and cure diseases in patients.
Health:pill.N	A small, usually cylindrical object designed for easy swallowing, usually containing some sort of medication.
Health:poison.N	A substance which, when ingested, inhaled, or absorbed, or when applied to, injected into, or developed within the body, in relatively small amounts, may cause injury, harm, or destruction to organs, tissue, or life.
Health:poisonous.A	That acts like a poison.
Health:rabid.A	Suffering from rabies.
Health:rabies.N	A viral disease that causes acute inflammation of the brain in humans and other warm-blooded animals.
Health:recover.V	To return to health and strength after illness.
Health:scabies.N	A contagious skin rash caused by the mite Sarcoptes scabiei.
Health:see a doctor.V	To go to a doctor.
Health:stethoscope.N	An acousting medical device for auscultation.
Health:tablet.N	A pill; a small, easily swallowed portion of a substance.
House:bamboo mat.N	A mat made from bamboo.
House:bathroom.N	A room containing a shower or a bathtub, and that may contains a toilet or not.
House:bathtub.N	A large container for holding water in which a person may take a bath.
House:bed.N	A piece of furniture, made for a person to sleep on.
House:bedroom.N	The area where people sleep.
House:bench.N	A piece of furniture offering place for many people.
House:blanket.N	A large cloth used for warmth and for sleeping.
House:cradle.N	A bed for a baby.
House:curtain.N	Piece of cloth on a window intended to obscure the interior of a room or to prevent people from looking inside.
House:door knocker.N	An item at a door that allows people outside a house to alert those inside.
House:escalator.N	A moving staircase.
House:guestroom.N	A room for guests.
House:kitchen.N	A room equipped for preparing and cooking food.
House:mattress.N	A pad on which a person can recline and sleep.
House:pillow.N	Cushion placed under the head for sleeping.
House:rug.N	A piece of thick cloth or wool that is smaller than a carpet and is put on the floor as decoration.
House:sink.N	A bowl for washing hands, dishwashing or other purposes, often affixed to a wall.
House:toilet.N	A room equipped with a toilet for urinating and defecating.
Hunting:boomerang.N	A tool with a curved shape used as a weapon or for sport which returns when thrown into the air.
Hunting:bow string.N	The string of a bow used to hunt.
Hunting:fishing.V	To hunt for fishes (general expression).
Hunting:game.N	Wild animal hunted for food.
Hunting:harpoon.N	A spearlike weapon with a barbed head used in hunting whales and large fish.
Hunting:hunt.V	To chase down prey and (usually) kill it.
Hunting:hunter.N	A person who hunts game.
Hunting:hunting dog.N	A type of canine bred for hunting or a dog trained to assist humans with hunting.
Hunting:net fishing.V	To hunt for fishes by using a fishnet.
Hunting:net.N	A grid-like device used for fishing and sports.
Language:book.N	A collection of leaves of paper, parchment or other material, usually bound or fastened together within covers, containing writing of any type or blank pages for future inscription.
Law:commit a crime.V	
Law:crime.N	Any act done in violation of those duties which an individual owes to the community, and for the breach of which the law has provided that the offender shall make satisfaction to the public. (Source: BLACK)
Law:lawyer.N	
Law:verdict.N	
Literature:alphabet.N	alphabet
Material:brass.N	The copper-zinc alloy. A yellow-colored metal made of the mixture of copper and zinc and used in the making of decorations and musical instruments.
Material:canvas.N	A type of coarse cloth, woven from hemp, useful for making sails and tents or as a surface for paintings.
Matter:rust.N	Any of various metallic coatings formed by corrosion, especially after oxidation in presence of water.
Matter:rusty.A	Having been affected by rust.
Mind:dream.N	Successions of images, ideas, emotions, and sensations that occur usually involuntarily in the mind during certain stages of sleep.
Mind:dream.V	To experience while sleeping.
Mind:dreaming.N	Either the act of seeing images when sleeping, or the result of this act, the dream itself.
Mind:mad person.N	A person that has mental problems.
Motion:approach.V	To come near to; to move towards.
Motion:arrive.V	To come to a destination.
Motion:bend (oneself).V	To turn oneself over.
Motion:block.V	To prevent somebody or something from passing.
Motion:bring.V	To transport toward somewhere; to take something or somebody with oneself somewhere.
Motion:carry.V	To lift and bring to somewhere else; to transport by lifting.
Motion:catch.V	To take hold of, especially in the hands, so as to seize or restrain or stop the motion of.
Motion:climb.V	To mount to a high or little accessible place using feet and hands, e.g. a tree, a mountain or a ladder.
Motion:come back.V	To go there where one was before.
Motion:come.V	To move toward or to reach either the speaker, the person spoken to, or the subject of the speaker's narrative.
Motion:crawl or creep.V	To move using ones hands and knees or with one's belly touching the ground.
Motion:crawl.V	To move using ones hands and knees.
Motion:creep.V	To move with one's belly touching the ground.
Motion:drag.V	To draw slowly or heavily.
Motion:drop (something).V	To let something fall down.
Motion:enter.V	To go into.
Motion:fall.V	To descend in free fall due to the effect of gravity.
Motion:fly.V	To move autonomously through the air, without any part of the object or object's enclosure touching anything attached to the ground.
Motion:follow.V	To go or come after (in physical space) someone or something.
Motion:go.V	To get from one place to another by any means.
Motion:leave.V	To move away from a place, a situation or a talk.
Motion:lift.V	To cause an object to have a higher location than previously.
Motion:move (oneself).V	To get oneself in motion in order to arrive at some other place.
Motion:raise.V	To cause to rise; to move something from a lower position to a higher one.
Motion:ride.V	To transport oneself by sitting on and directing an animal.
Motion:roll.V	To move like a ball/cylinder by turning over and over.
Motion:run away.V	Leave a dangerous situation by moving one's body away from it.
Motion:step.V	To move the foot in walking; to advance or recede by raising and moving one of the feet to another resting place, or by moving both feet in succession.
Motion:swing (sth).V	To set something in swinging motion.
Motion:swing.N	Tool used for play with a seat hanging from ropes.
Motion:swing.V	To move freely to and fro.
Motion:take a walk.V	To wander around.
Motion:trail.N	The track or indication marking the route followed by something that has passed, such as the footprints of animal on land or the contrail of an airplane in the sky.
Motion:turn (sth).V	To position by moving an object around its axis.
Motion:turn.V	To change the direction of movement or the direction in which something is facing.
Motion:walk.N	The act of walking, the way one walks.
Motion:walking stick.N	An object, specifically for providing support when walking.
Music:accordion.N	A musical instrument.
Music:brass instrument.N	Any musical instrument that is a member of the brass family of musical instruments, usually a horn or a trumpet.
Music:drum.N	A percussion instrument consisting of at least one membrane that is stretched over a shell and struck directly with the player's hands or with a drumstick.
Music:erhu.N	A two-stringed fiddle common in Eastern Asia; Chinese violin, Chinese two-stringed fiddle.
Music:folk song.N	A traditional piece of music with words to sing.
Music:gong.N	An African, East and South East Asian musical percussion instrument that takes the form of a flat, circular metal disc which is hit with a mallet.
Music:government.N	A body that has the authority to make and the power to enforce laws within a civil, corporate, religious, academic, or other organization or group.
Music:guitar.N	Musical instrument with usually six strings.
Music:harmonica.N	A mouth organ (musical instrument).
Music:harp.N	A string musical instrument.
Music:horn.N	A wind instrument made of a wound copper tube with a wide sound bucket and valves.
Music:jew‚Äôs harp.N	A small musical instruments put between the teeth and played with a finger.
Music:jingle.N	"One of a cluster of small bells, shaken or tapped on the palm of the player's hand. The small metal discs arranged around the frame of a tambourine are also called ""jingles""."
Music:lute.N	A plucked string musical instrument with with a neck and a deep round back.
Music:mouth harp.N	Lamellophone instrument consisting of a tongue or reed attached to a frame, placed in the performer's mouth and plucked; Jew's harp, jaw harp.
Music:music.N	The artistic organisation of sounds or tones that expresses ideas and emotions through the elements of rhythm, melody, harmony and tonal colour.
Music:piano.N	A large musical instrument with a row of black and white keys that are pressed to play notes.
Music:play.V	Execute coordinated movements on or with a musical instrument to produce sounds.
Music:reed pipe.N	Organ pipe that is sounded by a vibrating a metal tongue which rests against a tunnel.
Music:sing.V	To produce harmonious sounds with one's voice.
Music:song.N	A musical piece with lyrics (or words to sing); prose that one can sing.
Music:tambourine.N	Musical instrument with round, wooden frame and covered by skin, plastic, etc. with metal discs around the frame.
Music:tone.N	Traditionally in Western music, a musical tone is a steady periodic sound.
Music:violin.N	
Music:violinist.N	
Music:whistle instrument.N	Wind instrument most often made out of metal or wood used for producing a loud, shrill tone.
Nature:flame.N	A bright yellow, red or bluish light which emerges during combustion processes.
Nature:flame.V	To be on fire and producing especially bright flames
Nature:nature.N	The physical world including all living things as well as the land and the seas.
Nature:river bed.N	The channel containing or formerly containing the water of a river.
Nature:river mouth.N	A river mouth or stream mouth is a part of a river where it flows into the sea, river, lake, reservoir or ocean.
Nature:river or water.N	Common liquid (H‚ÇÇO) which forms rain, rivers, the sea, etc, or a stream of this liquid flowing in a channel.
Nature:river.N	A stream of water which flows in a channel from high ground to low ground and ultimately to a lake or the sea, except in a desert area where it may dwindle away to nothing.
Nature:riverbank.N	The margin or shore of a river.
Nature:savanna.N	A large open grassland in tropical and subtropical regions.
Nature:scenery.N	The appearance of a landscape, in particular natural and aesthetically pleasing.
Nature:sea or ocean.N	A large body of salt water which is in proximity to a continent.
Nature:sea.N	A body of salt water that is smaller than an ocean and generally in proximity to a continent.
Nature:shore of lake.N	The margin or shore of a lake.
Nature:shore of sea.N	The margin or shore of a sea or ocean.
Nature:shore or bank.N	The land touching a body of water, irrespective of the special characteristics of the body of water.
Nature:shore.N	The margin or shore of a river, lake, or ocean.
Nature:slope.N	A stretch of ground forming a geological incline, e.g. a hillside.
People:adult.N	A fully grown and mature person.
People:baby.N	A very young human being, from birth to a year old.
People:bad person.N	A person with an evil character.
People:bastard.N	A child born of parents not married to each other.
People:black man.N	Term used to describe men who are perceived to be dark-skinned.
People:black woman.N	Term used to describe women who are perceived to be dark-skinned.
People:blind person.N	Person who has a complete lack of form and visual light perception.
People:boy or son.N	Either a son or a boy.
People:boy.N	A young male person, usually a child or teenager.
People:brave person.N	A person with a brave character.
People:chatterer.N	A person who talks a lot.
People:child or offspring.N	A young human or the descendant of a human.
People:child.N	A person below the age of puberty.
People:daughter or girl.N	Either a daughter or a girl.
People:deaf person.N	Person who is  partial or total unable to hear.
People:disabled person.N	A person with a physical condition or mental disorder that is characterized by physical, sensory, cognitive or intellectual impairment.
People:female.A	Relating to the female sex of humans.
People:female.N	A human belonging to the female sex.
People:fool.N	A person with poor judgment or little intelligence.
People:girl.N	A young female person, usually a child or teenager.
People:guest or stranger.N	Either a guest or a stranger.
People:husband or man.N	Either the male partner in a marriage or a male person.
People:male.A	Relating to the male sex of humans.
People:man or person.N	Either a man or a person (in general).
People:man.N	An adult human member of the sex that begets young by fertilizing ova.
People:old man.N	A male person who is old of age.
People:old person.N	An older person (usually considered to be above the age of 60).
People:old woman.N	An old woman.
People:people.N	Either multiple human beings or one human being.
People:twins.N	A case of multiple birth in which the mother gives birth to two offspring from the same pregnancy.
People:virgin.N	A person who has never engaged in sexual intercourse.
People:white man.N	Term used to describe men who are perceived to be light-skinned.
People:white woman.N	Term used to describe women who are perceived to be light-skinned.
People:woman.N	An adult human member of the sex that produces ova and bears young.
People:young man.N	A male juvenile between the onset of puberty and maturity; in the state of development between puberty and maturity.
People:young woman.N	A female juvenile between the onset of puberty and maturity; in the state of development between puberty and maturity.
Perception:feel.V	To sense something by touching its surface.
Perception:feeling sense.N	The sense that enables to perceive surfaces of things.
Perception:hear or listen.V	To perceive sound with the ear, with or without paying attention to it.
Perception:hear.V	To perceive sound with the ear, without necessarily paying attention to it.
Perception:touch.V	To put one's hand on something/someone so that one can feel them. To be in physical contact with.
Plant:Adesmia campestris.N	The mamuelchoique, a kind of shrub of species Adesmia campestris.
Plant:Aglaia odorata.N	A shrub or small tree in the mahogany family, from south China and Indo-China, grown ornamentally for the handsome leaves and fragrant flowers, which are tiny, round, and yellow; clusters of them are used for leis.
Plant:Ananas comosus.N	A tropical plant with edible multiple fruit consisting of coalesced berries, also called pineapples, and the most economically significant plant in the Bromeliaceae family.
Plant:Annona montana.N	Type of tree found in the Amazon
Plant:Annona squamosa.N	A West Indian tree that bears edible fruit.
Plant:Beta vulgaris saccharifera.N	The sugar beet.
Plant:Betula.N	A tree of the genus Betula, with small leaves and a trunk that is white with darker blotches.
Plant:bran.N	The hard outer layers of cereal grain. It consists of the combined aleurone and pericarp.
Plant:branch or twig.N	A woody part of a tree arising from the trunk or from another branch.
Plant:branch.N	A woody part of a tree arising from the trunk and usually dividing.
Plant:Brassica oleracea gongylodes.N	A variety of the cabbage, having a turnip-shaped edible stem. 
Plant:Brassica rapa.N	A cultivated Eurasian plant, Brassica rapa, of the mustard family, whose whitish root and leaves are edible.
Plant:Bromeliaceae.N	Any of various tropical or subtropical New World herbaceous plants in the family Bromeliaceae.
Plant:bud.N	A bud is an undeveloped or embryonic shoot and normally occurs in the axil of a leaf or at the tip of the stem.
Plant:bulb.N	A bulb is the part of some plants that stores food while the plant is resting from growing.
Plant:Ceiba pentandra.N	A tree of the tropical Americas and west-central Africa, with white flowers, cultivated in south-east Asia for its seed fibre.
Plant:Citrus sinensis.N	Ttree of the species Citrus sinensis.
Plant:Colocasia esculenta.N	Colocasia esculenta, raised as a food primarily for its corm, which distantly resembles potato.
Plant:coniferous.N	The type of tree that bears cones.
Plant:Cucumis melo.N	A fruit of any of the species from the family Cucurbitaceae that has relatively hard inedible shells and plenty of sweet flesh. The fruits may vary in size but is usually not smaller than one decimeter in diameter.
Plant:Ficus carica.N	fig (tree/fruit of genus Ficus)
Plant:Fraxinus.N	The ash tree, a tree that has compound leaves and a tough, flexible wood.
Plant:Glycine max.N	An annual plant native to East Asia that is widely cultivated for its fruit.
Plant:Gossypium.N	Plant of genus Gossypium whose fibers are used for making cloth.
Plant:Helianthus annuus.N	Annual plant with a large yellow flowering head of the genus Helianthus and the family of the Asteraceae.
Plant:leaf spine.N	A hard, rigid extension of leaves with sharp, stiff ends.
Plant:leaf.N	The main organ of photosynthesis and transpiration in higher plants, usually consisting of a flat green blade attached to the stem directly or by a stalk.
Plant:Lupin.N	Any plant of the genus Lupin; bearing erect spikes of usually purplish-blue flowers.
Plant:Metroxylon sagu.N	Common name for several plants which are used to produce a starchy food known as sago.
Plant:needle.N	A needle of coniferous tree.
Plant:Parkia biglobosa.N	The African locust bean, a perennial deciduous tree in the family Fabaceae.
Plant:plant.N	Any living organism that synthesizes its food from inorganic substances, possesses cellulose cell walls, responds slowly and often permanently to a stimulus, lacks specialized sense organs and nervous system, and has no powers of locomotion.
Plant:Prunus armeniaca.N	A tree that bears the apricot fruit.
Plant:Prunus salicina.N	An Asian tree species classified in the Armeniaca section of the genus Prunus subgenus Prunus.
Plant:reed.N	Any of various types of tall stiff grass-like plants growing together in groups near water.
Plant:root.N	The absorbing and anchoring organ of a vascular plant; it bears neither leaves nor flowers and is usually subterranean.
Plant:sap.N	The juice of plants of any kind, especially the ascending and descending juices or circulating fluid essential to nutrition.
Plant:seed.N	A mature fertilized plant ovule, consisting of an embryo and its food store surrounded by a protective seed coat (testa).
Plant:seedling.N	A young plant produced from a seed.
Plant:Setaria italica.N	Foxtail millet.
Plant:Solanum oblongifolium.N	An Andean weed that grows in dry parts of forest and has white flowers and produces berries.
Plant:Sorghum bicolor.N	A cereal, Sorghum bicolor (syn. Sorghum vulgare), the grains of which are used to make flour and as cattle feed.
Plant:sprout.N	The early growth of a plant.
Plant:sprout.V	The process by which a plant grows from a seed.
Plant:stem.N	One of two main structural axes of a vascular plant, the other being the root.
Plant:sucker.N	An undesired stem growing out of the roots or lower trunk of a shrub or tree, especially from the rootstock of a grafted plant or tree.
Plant:tree stump.N	The short piece left over after cutting off the most part.
Plant:tree stump.N	A small remaining portion of the trunk of a tree with the roots still in the ground.
Plant:tree trunk.N	The main structural member of a tree.
Plant:tree.N	Any large woody perennial plant with a distinct trunk giving rise to branches or leaves at some distance from the ground.
Plant:treetop.N	The uppermost part of a tree; crown.
Plant:twig.N	A branch that doesn't arise from the trunk but from another branch.
Plant:Vaccinium mortinia.N	Vaccinium mortinia, a dark red berry.
Plant:Vicia.N	Any of various herbs of the genus Vicia, having pinnately compound leaves that terminate in tendrils and small, variously colored flowers.
Plant:vine.N	A climbing plant which grows up or over things. This also includes types which do not produce grapes.
Possession:abandon.V	To give up control of, to surrender something.
Possession:beg.V	To make a living by asking people for money or food.
Possession:exchange.V	To hand out one thing while receiving another thing or to replace one thing with another.
Possession:generous.A	Willing to give more than expected, especially money.
Possession:gift.N	A gift or a present is an item given to someone without the expectation of payment or return.
Possession:gratis.A	Free of charge, without cost.
Possession:greedy.A	Excessively desirous of money, wealth or possessions.
Possession:possessions.N	The totality of things that someone owns; their property or belongings.
Possession:receive.V	To get something given into one‚Äôs possession.
Possession:rob.V	To illegally take something from, especially using force or violence.
Quantity:0.NUM	The integer zero (0).
Quantity:1.NUM	The natural number one (1).
Quantity:10.NUM	The natural number ten (10).
Quantity:10^10.NUM	The natural number ten billion (10000000000).
Quantity:10^11.NUM	The natural number one hundred billion (100000000000).
Quantity:10^12.NUM	The natural number one trillion (1000000000000).
Quantity:10^4.NUM	The natural number ten thousand (10000).
Quantity:10^5.NUM	The natural number one hundred thousand (100000).
Quantity:10^6.NUM	The natural number one million (1000000).
Quantity:10^7.NUM	The natural number ten million (10000000).
Quantity:10^8.NUM	The natural number one hundred million (100000000).
Quantity:100.NUM	The natural number one hundred (100).
Quantity:1000.NUM	The natural number one thousand (1000).
Quantity:1001.NUM	The natural number one thousand and one (1001).
Quantity:101.NUM	The natural number one hundred and one (101).
Quantity:102.NUM	The natural number one hundred and two (102).
Quantity:1027.NUM	The natural number one thousand and twenty-seven (1027).
Quantity:103.NUM	The natural number one hundred and three (103).
Quantity:1060.NUM	The natural number one thousand and sixty (1060).
Quantity:108.NUM	The natural number one hundred and eight (108).
Quantity:11.NUM	The natural number eleven (11).
Quantity:110.NUM	The natural number one hundred and ten (110).
Quantity:111.NUM	The natural number one hundred and eleven (111).
Quantity:12.NUM	The natural number twelve (12).
Quantity:120.NUM	The natural number one hundred and twenty (120).
Quantity:123.NUM	The natural number one hundred and twenty-three (123).
Quantity:13.NUM	The natural number thirteen (13).
Quantity:133.NUM	The natural number one hundred and thirty-three (133).
Quantity:14.NUM	The natural number fourteen (14).
Quantity:140.NUM	The natural number one hundred and forty (140).
Quantity:144.NUM	The natural number one hundred and forty-four (144).
Quantity:15.NUM	The natural number fifteen (15).
Quantity:150.NUM	The natural number one hundred and fifty (150).
Quantity:16.NUM	The natural number sixteen (16).
Quantity:160.NUM	The natural number one hundred and sixty (160).
Quantity:17.NUM	The natural number seventeen (17).
Quantity:18.NUM	The natural number eighteen (18).
Quantity:180.NUM	The natural number one hundred and eighty (180).
Quantity:19.NUM	The natural number nineteen (19).
Quantity:2.NUM	The natural number two (2).
Quantity:20.NUM	The natural number twenty (20).
Quantity:200.NUM	The natural number two hundred (200).
Quantity:2000.NUM	The natural number two thousand (2000).
Quantity:2000000.NUM	The natural number two million (2000000).
Quantity:2002.NUM	The natural number two thousand and two (2002).
Quantity:201.NUM	The natural number two hundred and one (201).
Quantity:202.NUM	The natural number two hundred and two (202).
Quantity:21.NUM	The natural number twenty-one (21).
Quantity:210.NUM	The natural number two hundred and ten (210).
Quantity:216.NUM	The natural number two hundred and sixteen (216).
Quantity:22.NUM	The natural number twenty-two (22).
Quantity:23.NUM	The natural number twenty-three (23).
Quantity:231.NUM	The natural number two hundred and thirty-one (231).
Quantity:24.NUM	The natural number twenty-four (24).
Quantity:240.NUM	The natural number two hundred and forty (240).
Quantity:25.NUM	The natural number twenty-five (25).
Quantity:250.NUM	The natural number two hundred and fifty (250).
Quantity:26.NUM	The natural number twenty-six (26).
Quantity:27.NUM	The natural number twenty-seven (27).
Quantity:28.NUM	The natural number twenty-eight (28).
Quantity:29.NUM	The natural number twenty-nine (29).
Quantity:3.NUM	The natural number three (3).
Quantity:30.NUM	The natural number thirty (30).
Quantity:300.NUM	The natural number three hundred (300).
Quantity:3000.NUM	The natural number three thousand (3000).
Quantity:304.NUM	The natural number three hundred and four (304).
Quantity:31.NUM	The natural number thirty-one (31).
Quantity:32.NUM	The natural number thirty-two (32).
Quantity:33.NUM	The natural number thirty-three (33).
Quantity:34.NUM	The natural number thirty-four (34).
Quantity:35.NUM	The natural number thirty-five (35).
Quantity:36.NUM	The natural number thirty-six (36).
Quantity:37.NUM	The natural number thirty-seven (37).
Quantity:38.NUM	The natural number thirty-eight (38).
Quantity:39.NUM	The natural number thirty-nine (39).
Quantity:399.NUM	The natural number three hundred and ninety-nine (399).
Quantity:4.NUM	The natural number four (4).
Quantity:40.NUM	The natural number forty (40).
Quantity:400.NUM	The natural number four hundred (400).
Quantity:4000.NUM	The natural number four thousand (4000).
Quantity:41.NUM	The natural number forty-one (41).
Quantity:42.NUM	The natural number forty-two (42).
Quantity:43.NUM	The natural number forty-three (43).
Quantity:44.NUM	The natural number forty-four (44).
Quantity:45.NUM	The natural number forty-five (45).
Quantity:46.NUM	The natural number forty-six (46).
Quantity:46656.NUM	The natural number forty six thousand six hundred and fifty six (46656).
Quantity:47.NUM	The natural number forty-seven (47).
Quantity:48.NUM	The natural number forty-eight (48).
Quantity:49.NUM	The natural number forty-nine (49).
Quantity:5.NUM	The natural number five (5).
Quantity:50.NUM	The natural number fifty (50).
Quantity:500.NUM	The natural number five hundred (500).
Quantity:5000.NUM	The natural number five thousand (5000).
Quantity:51.NUM	The natural number fifty-one (51).
Quantity:52.NUM	The natural number fifty-two (52).
Quantity:53.NUM	The natural number fifty-three (53).
Quantity:54.NUM	The natural number fifty-four (54).
Quantity:55.NUM	The natural number fifty-five (55).
Quantity:56.NUM	The natural number fifty-six (56).
Quantity:57.NUM	The natural number fifty-seven (57).
Quantity:58.NUM	The natural number fifty-eight (58).
Quantity:59.NUM	The natural number fifty-nine (59).
Quantity:6.NUM	The natural number six (6).
Quantity:60.NUM	The natural number sixty (60).
Quantity:600.NUM	The natural number six hundred (600).
Quantity:6000.NUM	The natural number six thousand (6000).
Quantity:61.NUM	The natural number sixty-one (61).
Quantity:62.NUM	The natural number sixty-two (62).
Quantity:63.NUM	The natural number sixty-three (63).
Quantity:64.NUM	The natural number sixty-four (64).
Quantity:65.NUM	The natural number sixty-five (65).
Quantity:66.NUM	The natural number sixty-six (66).
Quantity:67.NUM	The natural number sixty-seven (67).
Quantity:68.NUM	The natural number sixty-eight (68).
Quantity:69.NUM	The natural number sixty-nine (69).
Quantity:7.NUM	The natural number seven (7).
Quantity:70.NUM	The natural number seventy (70).
Quantity:700.NUM	The natural number seven hundred (700).
Quantity:7000.NUM	The natural number seven thousand (7000).
Quantity:71.NUM	The natural number seventy-one (71).
Quantity:72.NUM	The natural number seventy-two (72).
Quantity:73.NUM	The natural number seventy-three (73).
Quantity:74.NUM	The natural number seventy-four (74).
Quantity:75.NUM	The natural number seventy-five (75).
Quantity:76.NUM	The natural number seventy-six (76).
Quantity:77.NUM	The natural number seventy-seven (77).
Quantity:7776.NUM	The natural number seven thousand seven hundred and seventy-six (7776).
Quantity:78.NUM	The natural number seventy-eight (78).
Quantity:79.NUM	The natural number seventy-nine (79).
Quantity:8.NUM	The natural number eight (8).
Quantity:80.NUM	The natural number eighty (80).
Quantity:800.NUM	The natural number eight hundred (800).
Quantity:8000.NUM	The natural number eight thousand (8000).
Quantity:81.NUM	The natural number eighty-one (81).
Quantity:82.NUM	The natural number eighty-two (82).
Quantity:83.NUM	The natural number eighty-three (83).
Quantity:84.NUM	The natural number eighty-four (84).
Quantity:85.NUM	The natural number eighty-five (85).
Quantity:86.NUM	The natural number eighty-six (86).
Quantity:87.NUM	The natural number eighty-seven (87).
Quantity:88.NUM	The natural number eighty-eight (88).
Quantity:89.NUM	The natural number eighty-nine (89).
Quantity:9.NUM	The natural number nine (9).
Quantity:90.NUM	The natural number ninety (90).
Quantity:900.NUM	The natural number nine hundred (900).
Quantity:9000.NUM	The natural number nine thousand (9000).
Quantity:91.NUM	The natural number ninety-one (91).
Quantity:92.NUM	The natural number ninety-two (92).
Quantity:93.NUM	The natural number ninety-three (93).
Quantity:94.NUM	The natural number ninety-four (94).
Quantity:95.NUM	The natural number ninety-five (95).
Quantity:96.NUM	The natural number ninety-six (96).
Quantity:97.NUM	The natural number ninety-seven (97).
Quantity:98.NUM	The natural number ninety-eight (98).
Quantity:99.NUM	The natural number ninety-nine (99).
Quantity:999.NUM	The natural number nine hundred and ninety-nine (999).
Quantity:a little.A	More than one, but not as much as usual or as expected. (for mass nouns)
Quantity:add.V	Join or unite so as to bring about an increase.
Quantity:by.ADP	Distributive numeral marker.
Quantity:decrease.V	To become smaller in number or size.
Quantity:fill.V	To make full.
Quantity:increase.V	(Of a quantity) to become bigger.
Society:help.N	The act of helping someone.
Society:help.V	To give assistance or aid to.
Society:lover.N	
Sound:be silent.V	To stop speaking or making noise.
Sound:bell.N	A simple sound-making device.
Sound:chime.V	To ring the bells.
Sound:clap.V	Make noise by putting one's hand together.
Sound:crow.V	To utter the characteristic cry of a rooster.
Sound:flute.N	A musical instrument of the woodwind family.
Sound:hiss.V	To produce a continuous voiceless sibilant sound like a long /s/.
Sound:howl.N	A loud vocalisation inflicted by pain.
Sound:howl.V	To cry like a wolf, dog, or other canids.
Sound:make noise.V	To be loud.
Sound:rattle.N	A wooden instrument that makes a loud knocking noise [used by people watching football games].
Sound:roar.V	To make a deep loud cry (of lions and comparable wild animals); to make a deep loud cry, usually out of anger (of humans).
Sound:rustle (of leaves).V	A sound emitted by leaves moving in the trees.
Sound:scream.N	A loud vocalisation.
Sound:scream.V	To give a loud cry out of pain, fear or excitement. The vocalisation resulted from screaming is distinct from that produced by shrieking in that it is typically characterized by a longer duration and lower pitch.
Sound:shout.V	To say something in a loud voice.
Sound:shriek.V	To make a short, loud and high-pitched sound in reaction to something.
Sound:sound (of instrument or voice).V	The noise emitted by musical instruments or humans speaking.
Sound:string instrument.N	A string instrument.
Sound:stutter.V	To have problems articulating the words, repeting sometimes some syllables.
Sound:stutterer.N	A person that stutters.
Sound:ululate.V	To ululate.
Sound:voice.N	The sound and tones human beings are able to produce with the vocal cords.
Sound:whisper.V	To speak in a quiet voice, without vibration of the vocal cords.
Sound:whistle.V	To make a sound or a melody by forcing the breath out between closed lips.
Space:apart.ADV	apart 
Space:back.ADV	Toward the previous place or condition where one came from.
Space:encircle.V	To enclose or cause to be enclosed; to surround; to confine.
Storage:bag.N	A container that stores things and is small enough so that one can wear it.
Storage:bamboo basket.N	A basket from bamboo that is carried on the back.
Storage:barrel.N	A cylindrical container for liquids and food.
Storage:basket.N	A lightweight container, generally round, open at the top, and tapering toward the bottom.
Storage:bottle.N	A container, typically made of glass and having a tapered neck, used for holding liquids.
Storage:box or chest.N	Either a generic manmade object with space in it that is used to keep and store many various different objects, or a strong box with a lid on top.
Storage:box.N	A generic man-made object with space in it (commonly made of cardboard or wood) that is used to keep and store many various different objects.
Storage:bucket.N	Typically a watertight, vertical cylinder or truncated cone, with an open top and a flat bottom, attached to a semicircular carrying handle called the bail.
Storage:can.N	A small, round-shaped metal container, used for different purposes like storing food or liquids, or collecting money.
Storage:case.N	A box possibly with compartments that can contain a number of identical items, like bottles.
Storage:envelope.N	An item to commonly used to package or wrap letters.
Storage:funnel.N	A pipe with a wide mouth used to channel liquid into containers with small opening.
Storage:heap.N	A collection of things thrown one on another.
Storage:lid.N	The cap of a container.
Storage:load (sth).V	To put a large quantity of things onto something.
Storage:load.N	The weight (materials, products, etc.) to be borne or conveyed.
Storage:misplace.V	To place something in a place where one cannot find it again or in a wrong place; to lose something.
Storage:netbag.N	Bag made of net used to carry things.
Storage:pack.V	To put something in a container so that it could be carried or transported.
Storage:package.N	package, packet, parcel
Storage:pouch.N	A small bag.
Storage:pour.V	To cause a liquid to flow into a container.
Storage:sack.N	A specific bag used to store or carry items.
Storage:tin (can).N	A tin-plate canister, often cylindrical, for preserved foods such as fruit, meat, or fish.
Storage:vase.N	An often round vessel which is used for decoration or for holding cut flowers.
Time:autumn or harvest season.N	The time during which crops are typically harvested, often co-occurring with the season of autumn.
Time:autumn.N	The season after summer and before winter, traditionally from September 21 to December 20 in the northern hemisphere and from March 21 to June 20 in the southern hemisphere.
Time:calendar.N	A table showing the months and days of the year.
Time:Chinese New Year.N	
Time:dry season.N	Yearly period of low rainfall in the tropics.
Time:final.A	The last, after all the others.
Time:hot season.N	Period of the year associated with hot or warm weather.
Time:hour.N	A time period of sixty minutes; one twenty-fourth of a day.
Time:last month.N	The month before this month.
Time:last year.N	The year before the current one.
Time:last.V	To endure, continue over time.
Time:late.ADV	Towards the end of a time period.
Time:long ago.ADV	At a time in the past, especially the distant past.
Time:monsoon season.N	A period of heavy rain particularly during summer time.
Time:month.N	A period into which a year is divided, historically based on the phases of the moon. In the Gregorian calendar there are twelve months.
Time:never.ADV	At no time.
Time:New Year.N	
Time:New Year's eve.N	The last day of the year.
Time:new.A	Recently made, created or begun.
Time:night.N	The period between sunset and sunrise, when a location faces far away from the sun, thus when the sky is dark.
Time:now or today.ADV	On the current day or in the current moment.
Time:now.ADV	At present; at this time.
Time:often.ADV	Many times, with short intervals between occasions.
Time:old (of man).A	Old of a man as opposed to old of a woman.
Time:old (of person).A	To be old (of persons).
Time:old (of woman).A	Old of a woman as opposed to old of a man.
Time:old (used).A	To be old (of things). That which has been used for a long time.
Time:old.A	Having lived or existed for a relatively long period of time.
Time:one time.ADV	An instance or occurrence of an event.
Time:pass.V	Of time, to elapse, to be spent.
Time:period.N	A length of time.
Time:rainy season.N	Period of year when most of a region's average annual rainfall occurs.
Time:rhythm.N	rhythm
Time:season.N	One of the four equal periods into which the year is divided by the equinoxes and solstices, resulting from the apparent movement of the sun north and south of the equator during the course of the earth's orbit around it. These periods (spring, summer, autumn and winter) have their characteristic weather conditions in different regions, and occur at opposite times of the year in the N and S hemispheres.
Time:short dry season.N	
Time:short.ADV	For a brief period or a short amount of time.
Time:springtime.N	Traditionally the first of the four seasons, the season of growth with an ever increasing amount of daytime.
Time:still.ADV	Continuance of motion or state even until the time mentioned.
Time:summer.N	Traditionally the second of the four seasons regarded as being from June 21 to September 20 (or just June, July and August) in the Northern Hemisphere and from December 21 to March 20 (or just December, January and February) in the Southern Hemisphere.
Time:three days before now.ADV	Three days before today.
Time:three days from now.ADV	Three days from today.
Time:time.N	The dimension of the physical universe which, at a given place, orders the sequence of events. The continuum of past-present-future.
Time:today.ADV	On the current day or date.
Time:tomorrow or yesterday.ADV	The day after the present day or the day before today.
Time:tomorrow.ADV	The day after the present day.
Time:wait.V	To refrain from acting or moving for some duration or until some event occurs.
Time:winter.N	Traditionally, the fourth of the seasons, marked by the applicable hemisphere of the planet being at its minimum angle of exposure to the Sun, resulting in short days, long nights and typically in low temperatures.
Time:year.N	The time it takes the Earth to complete one revolution of the Sun (between 365.24 and 365.26 days depending on the point of reference).
Time:yesterday.ADV	The day before today.
Transit:airplane.N	A powered heavier-than-air aircraft with fixed wings that obtains lift by the Bernoulli effect and is used for transportation.
Transit:anchor.N	Something, usually a heavy piece of metal with points which dig into the sea-bed, used to hold a boat in one position.
Transit:bicycle.N	A vehicle with two wheels in tandem, pedals connected to the rear wheel by a chain, handlebars for steering, and a saddlelike seat.
Transit:boat.N	A craft used for transportation of goods, fishing, racing, recreational cruising, or military use on or in the water, propelled by oars or outboard motor or inboard motor or by wind.
Transit:brake.V	Decelerate using a mechanical device.
Transit:bus.N	A large, long-bodied motor vehicle equipped with seating for passengers, usually operating as part of a scheduled service.
Transit:canoe.N	A light narrow boat driven by a paddle.
Transit:car.N	A four-wheeled motor vehicle used for land transport, usually propelled by a gasoline or diesel internal combustion engine.
Transit:carriage.N	A wheeled vehicle for people, usually horse-drawn.
Transit:carry (with pole on shoulder).V	The act of transporting something by means of a carrying pole placed on one's shoulder.
Transit:carry horizontally.V	To carry some object horizontally.
Transit:cart.N	A two-wheeled vehicle, commonly without springs, drawn by mules, oxen, or the like, used for the conveyance of heavy goods.
Transit:crane.N	A device for lifting and moving heavy objects, typically consisting of a moving boom, beam, or gantry from which lifting gear is suspended.
Transit:deliver.V	To bring or transport something to its destination.
Transit:driver's license.N	Official document granting someone the authorisation to drive some vehicles.
Transit:ferry.N	A transport ship used for small distances from one port to another which often runs on a regular schedule.
Transit:helicopter.N	A type of rotorcraft in which lift and thrust are supplied by rotors.
Transit:license plate.N	Metal sheet for alphanumerical identification of vehicles, on their front and/or rear parts.
Transit:motorcycle.N	Single-track, two-wheeled motor vehicle.
Transit:oar or paddle.N	Referring to tools used for water-based motion, either connected to the water vehicle or not.
Transit:oar.N	A pole with a blade at one end, and with the other end attached to the boat via an oarlock or thole, used to row or steer a boat.
Transit:paddle.N	A pole with a blade at one or both ends, the pole itself being not attached to the boat but held by both hands, used to row or steer a boat.
Transit:railroad.N	railroad
Transit:road.N	A long piece of hard ground that people can drive along from one place to another.
Transit:rocket.N	rocket
Transit:row.V	To pull oars through water in order to make a water vehicle (such as a boat) move.
Transit:rudder.N	An underwater vane used to steer a vessel. The rudder is controlled by means of a wheel, tiller or other apparatus.
Transit:saddle.N	A seat for an animal (especially horse) rider, secured by a girth.
Transit:sail.V	To traverse or travel by ship on a body of water.
Transit:sailcloth.N	A large piece of fabric (as canvas) by means of which wind is used to propel a sailing vessel.
Transit:ship.N	A vessel propelled by engines or sails for navigating on the water, especially a large vessel that can not be carried aboard another, as distinguished from a boat.
Transit:shoulder pole.N	A pole that is used to carry things on the shoulder.
Transit:spaceship.N	spaceship, starship
Transit:street.N	A paved part of road, usually in a village or a town.
Transit:train.N	A self-propelled, connected group of vehicles moving on rails.
Transit:transport.V	To carry larger objects, usually with help of a vehicle.
Transit:truck.N	truck {British: lorry} (motor vehicle for cargo-carrying)
Transit:vehicle.N	Any larger device that can be used to move persons and things.
Transit:wagon.N	A wheeled vehicle, generally drawn by horse power.
Transit:wheel.N	A circular object that spins around a central axe thereby allowing relatively low-friction movement.
Transit:wheelchair.N	A chair with wheels.
Value:be worth.V	To be worth of something.
Value:good.A	Having desired or positive qualities.
Value:important.A	Having relevant and crucial value.
